9 8
# # # # # # # # #
# h . h h h h h #
# . T h h h h h #
# . . h h T . h #
> . . B . B . . <
# h . T . . B . #
# h h h . B T h #
# # # # # # # # #
