8 7
# # # # # # # #
# h . B T T h #
# . . . . . h #
> . . T B . . <
# h . . B B . #
# h h . T h h #
# # # # # # # #
