8 11
# # # # # # # #
# h h h . h h #
# h h . . . h #
# h . . . . . <
# h h . B T h #
# . . . T B h #
> . . B . T h #
# h T . . B . #
# h h h . . . #
# h h h . . h #
# # # # # # # #
