9 6
# # # # # # # # #
# h h . . h T . <
# . B . . . B . #
> . . B . T . h #
# h h h . . T h #
# # # # # # # # #
