8 7
# # # # # # # #
# h . . h h h #
# T B . h h h #
> . . . T . . <
# h . . . B . #
# h T B . B T #
# # # # # # # #
