6 10
# # # # # #
# . . . h #
# T . B h #
# . . T h #
# h B h h #
# . . . h #
# T B . . <
> B . T h #
# h . h h #
# # # # # #
