11 9
# # # # # # # # # # #
# h h h h h h . h h #
# h . . . h T . . h #
# h . . . h B . T . <
# . . T . . . . B . #
> . . . . . B . . . #
# h . . h . . . . . #
# h h h h h . . h h #
# # # # # # # # # # #
