6 7
# # # # # #
# h . T . <
# . B B . #
> . . T . #
# h B . h #
# h T . h #
# # # # # #
