7 8
# # # # # # #
# h h . . h #
# h h B T h #
# h h . B H <
# . . B . . #
# . T . . h #
> . B T . h #
# # # # # # #
