9 10
# # # # # # # # #
# h h h . . T . <
# h h . . T B . #
# h h h . . B . #
# h h h . . h h #
# h . B . . h h #
> . . . . . T h #
# h . . . . . h #
# h h . . . h h #
# # # # # # # # #
