9 10
# # # # # # # # #
# h h . h h h h #
# h T B . h h h #
# h . . . h h h #
# h . . T h h h #
# h h B . . h h #
# . T . . . . . <
# . . . h B B T #
> . . . h . . . #
# # # # # # # # #
