9 10
# # # # # # # # #
# . . . h h h h #
# . . . h . T h #
> . . . . B . . <
# h h . . . B . #
# h . T B . . h #
# h . . . h h h #
# h h T . h h h #
# h h . . h h h #
# # # # # # # # #
