7 5
# # # # # # #
# h h T T h #
# . . B B . <
> . . B . T #
# # # # # # #
