9 9
# # # # # # # # #
# h . h h h . h #
# . B T h . T . <
# . . T . . . . #
> . B B h . . . #
# h . . . . . . #
# h . . . . . h #
# h h . . h h h #
# # # # # # # # #
