8 10
# # # # # # # #
# h h . . h h #
# h . . T h h #
# h . . T . . <
# h h . T . . #
# h h B . . h #
# . B . B . h #
# . . . h h h #
> B T . h h h #
# # # # # # # #
