10 6
# # # # # # # # # #
# h h . h T T B . <
# h . T B B T . . #
> . B . . . . . . #
# h . . . h h h h #
# # # # # # # # # #
