8 10
# # # # # # # #
# h . . . . h #
# . . . T . . <
# . . T T B . #
# h . . . B . #
# h . B . . h #
# . . . . h h #
# . . . . h h #
> . . . h h h #
# # # # # # # #
