9 8
# # # # # # # # #
# h h . h h h h #
# h . . T h h h #
# . . . T . h h #
> . . B B B . . <
# h . . h . . . #
# h h h h T . . #
# # # # # # # # #
