11 6
# # # # # # # # # # #
# h h . T h h h h h #
# T B . . T h . . h #
> . T B B . . . B . <
# h . . . . . . . . #
# # # # # # # # # # #
