8 10
# # # # # # # #
# T B . . . . <
# h . . T B . #
# T B . . . . #
# h h . . h h #
# h . . . h h #
> . B . . T h #
# h . . . . h #
# h h . . h h #
# # # # # # # #
