8 7
# # # # # # # #
# h . h h h h #
# . B . T T . <
# . . B . B . #
> T . T . B . #
# h . h h h h #
# # # # # # # #
