9 7
# # # # # # # # #
# . B . T h h h #
# . B . . . h h #
> . . . . T B . <
# h h h h . . . #
# h h h h T . . #
# # # # # # # # #
