9 8
# # # # # # # # #
# h h . h h h h #
# h T . . h h h #
> . . B . . h h #
# h . B T T . . <
# h h . h . B . #
# h h h h . . . #
# # # # # # # # #
