6 9
# # # # # #
# h . . . <
# h . B . #
# . . . T #
# B . . h #
# . . . h #
# . B T h #
> T . . h #
# # # # # #
