10 8
# # # # # # # # # #
# h h h h h . . h #
# h h . T . B . . <
# . . . . . . . T #
# . . B . . . . B #
> . . . . . T . . #
# h . . . h h h h #
# # # # # # # # # #
