7 5
# # # # # # #
# . T . B . <
# B . B T . #
> T . . . h #
# # # # # # #
