8 8
# # # # # # # #
# h . . . h h #
# . B . B . h #
> T . T . . . <
# h . . . . B #
# h . B T . T #
# h h . . h h #
# # # # # # # #
