8 5
# # # # # # # #
# h . . . . . <
> . B . T B B #
# h . . T . T #
# # # # # # # #
