7 9
# # # # # # #
# h . . . h #
# h B . . h #
# h T B . h #
# h h . . h #
# h . B . h #
> T T . . . <
# h . . . h #
# # # # # # #
