6 9
# # # # # #
# h . . . <
# h . B . #
# . . . . #
# . T h h #
# h B . . #
> T . . . #
# h T B . #
# # # # # #
