10 8
# # # # # # # # # #
# h h h . . h h h #
# h . . T . h h h #
# h . . . . . h h #
# . . . T . . . . <
> B T . B . . B . #
# h . . h . . h h #
# # # # # # # # # #
