5 8
# # # # #
# . . . <
# . B B #
# T . T #
# . . . #
> . B T #
# h . h #
# # # # #
