9 11
# # # # # # # # #
# h . h h h h h #
# . . . h h h h #
# . . . B T h h #
# . . . . . . . <
# h . h h B B . #
# . . h h T T . #
# . . h h h h h #
> . . h h h h h #
# h . h h h h h #
# # # # # # # # #
