10 11
# # # # # # # # # #
# h h h h T . . h #
# h h h h B . B h #
# h h h h . . T h #
# h h h h T B . h #
# h h h h h . h h #
# . . . h . . . h #
# . . . . . . . . <
> . . . h . . . h #
# h . h h h . h h #
# # # # # # # # # #
