8 9
# # # # # # # #
# h h h . . . <
# h h h . . . #
# h h . B . . #
# h . B T h h #
# h . . . h h #
# . . T . h h #
> B T h h h h #
# # # # # # # #
