8 10
# # # # # # # #
# h h . . . h #
# h . . T . . <
# h h T B . h #
# h . B . h h #
# . . . B T h #
> . . . . B h #
# h . . . . h #
# h . T h h h #
# # # # # # # #
