8 7
# # # # # # # #
# h . . . h h #
# . . . . T h #
> . B T B . . <
# h T . . B . #
# h T B . h h #
# # # # # # # #
