9 7
# # # # # # # # #
# h h h h . . . <
# . . T h B T . #
# . . . . . . . #
> B . . . B T . #
# h h . . h h h #
# # # # # # # # #
