9 6
# # # # # # # # #
# . . T T B . h #
# . . . . . B . <
> . . B . . . . #
# h h h h T . . #
# # # # # # # # #
