9 5
# # # # # # # # #
# . . T T . T . <
# . B . . B B . #
> . . . . . . . #
# # # # # # # # #
