10 6
# # # # # # # # # #
# h h . T h h h h #
# . . B . . B . . <
> . . . B . T . h #
# h h . T . . . . #
# # # # # # # # # #
