9 8
# # # # # # # # #
# h h h h . . . <
# h h h h T B . #
# h h h h B . . #
# T . . . T . . #
# . . B . h h h #
> . . . h h h h #
# # # # # # # # #
