8 6
# # # # # # # #
# h . B T . . <
# . . . B . T #
> . B T . . h #
# h . . h h h #
# # # # # # # #
