8 7
# # # # # # # #
# h h T B . h #
# h . T . T h #
> . . B B B . <
# h T . . . . #
# h h h . . h #
# # # # # # # #
