8 10
# # # # # # # #
# . . h . . h #
> . T . . . h #
# h B . . B . <
# h . T . . . #
# h h . . T h #
# h h . . B h #
# h h . . . h #
# h h . . h h #
# # # # # # # #
