9 8
# # # # # # # # #
# h h h h . . h #
# . B . T . . . <
# . . B . . . . #
# . . . h . T B #
# . . . h . . T #
> . . h h h h h #
# # # # # # # # #
