8 10
# # # # # # # #
# h h h . . h #
# h h h . . h #
# h h h B . . <
# h h . . . . #
# h . B T B h #
> . . T . T h #
# h . B T h h #
# h h . h h h #
# # # # # # # #
