6 8
# # # # # #
# . . . h #
# T B B h #
# T . . h #
# B T T h #
# . B . . <
> . . . h #
# # # # # #
