7 7
# # # # # # #
# h h . . h #
# h h T . h #
# h . . . . <
> . B . B T #
# h . B T h #
# # # # # # #
