6 11
# # # # # #
# h T T h #
# . B B h #
> . . . h #
# h B . h #
# h . . h #
# h T . h #
# h . T . <
# h . B . #
# h . . h #
# # # # # #
