7 8
# # # # # # #
# h . T h h #
# . B . B . <
> . B . . . #
# h . . . . #
# h T . T . #
# h h h . . #
# # # # # # #
