9 10
# # # # # # # # #
# h . h h h h h #
# . . . h . T . <
# . . . B . . . #
# . B . . . . T #
# h T h h h . h #
# h . B . h h h #
> B . . T h h h #
# h . . . h h h #
# # # # # # # # #
