10 6
# # # # # # # # # #
# h h T T . H . H <
# . B T . . B . . #
> B . B . B . B . #
# h . T . h h h h #
# # # # # # # # # #
