10 6
# # # # # # # # # #
# . . B . . . T . <
# h . B . h T . . #
> B . . . B . . T #
# h h h h h h T . #
# # # # # # # # # #
