8 10
# # # # # # # #
# . . . . . h #
# h T . T . h #
# . . . . . h #
# h h . . . . <
# h . B . . . #
> . B . B T h #
# h . B . . h #
# h h T . h h #
# # # # # # # #
