10 8
# # # # # # # # # #
# h h . . h h h h #
# T . . T . h . . <
# T . . . B . B . #
> B . . B . . . . #
# h h h h h h . T #
# h h h h h h . . #
# # # # # # # # # #
