11 10
# # # # # # # # # # #
# h h h h h . . . . <
# h h . . h . B T . #
# . . . . . T . . h #
# . . . B . h T h h #
> B . B . h T . . h #
# h . . . h . . . h #
# h h h h h . . . h #
# h h h h h h . h h #
# # # # # # # # # # #
