10 6
# # # # # # # # # #
# T . T . h h h h #
# . . T B . . . H <
> B . . B B B B T #
# h h h h . H . . #
# # # # # # # # # #
