10 6
# # # # # # # # # #
# h h . . . . . H <
# . B . T B T . T #
> T B . . B . B . #
# h . . h h h h h #
# # # # # # # # # #
