10 7
# # # # # # # # # #
# h h . . h h h h #
# T B . T . . . h #
> B . B . . T B . <
# h h . . . . . . #
# h h . T . . h h #
# # # # # # # # # #
