8 10
# # # # # # # #
# h . . B T H <
# h . T . B . #
# h h B . h h #
# h h . . h h #
# h . B . . h #
> . . . . . h #
# h . . T h h #
# h h . h h h #
# # # # # # # #
