9 8
# # # # # # # # #
# h h . T h h h #
# . . . . . h h #
# . B B . T . H <
# . . B . . . . #
> . . B . . T h #
# h h h . . . h #
# # # # # # # # #
