10 8
# # # # # # # # # #
# h h h h . . h h #
# h h . B T . . h #
# h h T . . . . H <
# h . . B h B . . #
> . . . . B . . T #
# h . . . h h h h #
# # # # # # # # # #
