11 8
# # # # # # # # # # #
# h h h h T T h h h #
# h h . B . . . h h #
# h . . . . . T . h #
> . . . B B B . . H <
# h . . . h . . . h #
# h h . h h h . h h #
# # # # # # # # # # #
