7 9
# # # # # # #
# T . . h h #
# . T . h h #
# . T . . h #
# . . B B h #
# . . . B H <
> B . . . . #
# h h . . h #
# # # # # # #
