7 8
# # # # # # #
# T B . h h #
# . B . . h #
> . B . . h #
# h h B T H <
# h h . . . #
# h h . T h #
# # # # # # #
