9 9
# # # # # # # # #
# h h . T h h h #
# . B . . . h h #
> . . . . . h h #
# h . . B . . H <
# h . . . . . T #
# h h B T B . . #
# h h . . h h h #
# # # # # # # # #
