10 6
# # # # # # # # # #
# . . T B T h h h #
# h . . B . . . . <
> . B T . B T . . #
# h h h h . . h h #
# # # # # # # # # #
