11 8
# # # # # # # # # # #
# h h . h h h h h h #
# h . T . h h h h h #
# h . . . B . . B H <
# . . B . . . . . . #
> B . . . . . T . . #
# h . . h h . T h h #
# # # # # # # # # # #
