8 7
# # # # # # # #
# h h . . h h #
# T . . B . h #
> B . . T B H <
# h h h . . B #
# h h h . T . #
# # # # # # # #
