9 6
# # # # # # # # #
# h h h h h . h #
# . T B . . . H <
# . . B B . T . #
> B T . . . . . #
# # # # # # # # #
