8 10
# # # # # # # #
# h h h . . h #
# h h h . . h #
# h h h T . . <
# h h h . T . #
# h . B . B h #
> . B . B . h #
# h . T . h h #
# h h T h h h #
# # # # # # # #
