8 10
# # # # # # # #
# h h h . h h #
# h h T . . h #
# h . . B B H <
# h h . . T h #
# h h . B h h #
# h . . . h h #
> T . . B . h #
# h . . . h h #
# # # # # # # #
