10 8
# # # # # # # # # #
# h h h h h h . h #
# h . . h . . T H <
# h B . . . . T . #
# . . . . B . B . #
> B . . . . h . h #
# h . T h h h h h #
# # # # # # # # # #
