9 7
# # # # # # # # #
# h h h . T h h #
# h . T . B . H <
# . . . B B B . #
# . . . . . . . #
> . T . h h h h #
# # # # # # # # #
