7 11
# # # # # # #
# h . . h h #
# h . . h h #
# h T T T h #
# . . . . h #
> . B . . h #
# h . . B h #
# h B . . H <
# h . . B . #
# h h . . h #
# # # # # # #
