9 9
# # # # # # # # #
# h h . . . . h #
# . . . . . . h #
# T B B . . . h #
> B . . . . . h #
# h . . h T B H <
# h h h h . . . #
# h h h h . T h #
# # # # # # # # #
