8 8
# # # # # # # #
# . T h h h h #
> B . . T h h #
# h . B B h h #
# h . B T . . <
# h . . . . T #
# h h . . h h #
# # # # # # # #
