9 8
# # # # # # # # #
# h h . . h h h #
# . B . T . h h #
# T T . . B h h #
> . . B T B . . <
# h h h . . . . #
# h h h h . . . #
# # # # # # # # #
