8 7
# # # # # # # #
# . . h h h h #
# B . . . . H <
# T . . . B . #
# . B B . . T #
> T . h h h h #
# # # # # # # #
