6 10
# # # # # #
# . . . h #
# B . . h #
> T . B h #
# h B . h #
# h . T h #
# h B T H <
# h . . . #
# h . . h #
# # # # # #
