10 8
# # # # # # # # # #
# h h . . h . . h #
# . . B . . . B . <
> . . B . T . . . #
# h . . B h h h h #
# h . T H . h h h #
# h h h T . h h h #
# # # # # # # # # #
