11 10
# # # # # # # # # # #
# h h . h h h T h h #
# h . . . h . . . h #
# h . B . . . . B H <
# h . . . . . . . . #
# h h . h . . . . . #
# h . . T h . . h h #
> T B . B h h h h h #
# h . . . h h h h h #
# # # # # # # # # # #
