9 8
# # # # # # # # #
# h h h h . . h #
# h h h h . . H <
# . . . B . B B #
# . T . T B . T #
> . . . . . h h #
# h . . h h h h #
# # # # # # # # #
