8 9
# # # # # # # #
# h h h . B H <
# h h h . . . #
# h . . . B . #
# . T . T B h #
> B . . . . h #
# h . . h h h #
# h T . h h h #
# # # # # # # #
