8 11
# # # # # # # #
# h . . . h h #
# . . . T . H <
# . . . B . . #
# h . B T . . #
# h . . . h h #
# h . . . h h #
> . . . B . h #
# h . B . . h #
# h h T . h h #
# # # # # # # #
