11 7
# # # # # # # # # # #
# h . . . h h h h h #
# h . . B h . . . h #
# . . B T . . B . H <
> B . T . . . . . . #
# h . T h h . . h h #
# # # # # # # # # # #
