8 8
# # # # # # # #
# h h h T T h #
# h h T . B h #
# . . B . . . <
> B . B . . . #
# h . . . T h #
# h h . . . h #
# # # # # # # #
