10 8
# # # # # # # # # #
# h h h h . . h h #
# h h T . . . . h #
# T B . . . . . . <
> . B . B . . . T #
# h . B . h . . . #
# h . . T h h h h #
# # # # # # # # # #
