10 10
# # # # # # # # # #
# h . . . h h h h #
# h . B . h h h h #
# h . . . h h h h #
# h B B . h h h h #
# h T B . h . . . <
> . . T . . T . . #
# h . . . h . . . #
# h h h h h T . . #
# # # # # # # # # #
