10 11
# # # # # # # # # #
# h h h h h . h h #
# h h h h . . . h #
# . . B . . T . . <
# . B . h . T T h #
# . B . h h B h h #
> . . . h . . . h #
# h h h T . . . h #
# h h h h . . . h #
# h h h h h . h h #
# # # # # # # # # #
