11 7
# # # # # # # # # # #
# h h . . h h . . h #
# . B . . B . . B H <
> . . B . . . . T T #
# h h . . . . h h h #
# h h h . T . h h h #
# # # # # # # # # # #
