7 11
# # # # # # #
# T T . . . <
# . . . . . #
# h B . h h #
# h . . h h #
# . B . h h #
> B . . T T #
# h . B . . #
# h . . . . #
# h h h . h #
# # # # # # #
