8 10
# # # # # # # #
# h h . T h h #
# h . B . h h #
# h . . B . h #
# . . . . . h #
> . B B . h h #
# h h . . T . <
# h h T . . . #
# h h . . T . #
# # # # # # # #
