9 11
# # # # # # # # #
# h T . h h h h #
# . . . . . . h #
# . . . . . . . <
# h T . h h h h #
# h T . . h h h #
# h B . . h h h #
# . B . B T h h #
> B . . . . h h #
# h h . . h h h #
# # # # # # # # #
