10 9
# # # # # # # # # #
# . h T h h h h h #
# . . . h h h h h #
# . . T h h . T h #
# . . . B . . . . <
# . T . B . . B . #
> . . . . . B . h #
# h . . h h . h h #
# # # # # # # # # #
