8 11
# # # # # # # #
# h h h h T h #
# h . T . . . <
# . . . . . . #
> B . B . B . #
# h T . h . h #
# h . . h h h #
# h B . h h h #
# h . . h h h #
# h T h h h h #
# # # # # # # #
