7 8
# # # # # # #
# h . T . . <
# . . . . . #
# . B . . h #
# T . B T T #
> . B . B . #
# h . . h h #
# # # # # # #
