8 9
# # # # # # # #
# T T . . . h #
# h . . B . h #
> B . . . . h #
# h h . B . . <
# h h B . . . #
# h h . T . h #
# h h . . T h #
# # # # # # # #
