9 9
# # # # # # # # #
# h h h h . . . <
# . . T h . . . #
# . . B . . . T #
> B . . B . h h #
# h h . . . B . #
# h h h . . T . #
# h h h T . . . #
# # # # # # # # #
