7 11
# # # # # # #
# h . . h h #
# h B . . h #
# h . . . h #
# h . B B . <
# h B . . . #
# . T . . h #
# . T . . h #
> . T . h h #
# h T h h h #
# # # # # # #
