11 8
# # # # # # # # # # #
# h h h h h T . . h #
# h h . . h . . B h #
# T . B . T . . . . <
> . . . . . . B B . #
# h . T . h . . h h #
# h h . . h h h h h #
# # # # # # # # # # #
