8 9
# # # # # # # #
# . . h h h h #
# . . . h h h #
# . B . h h h #
> B T B h h h #
# h . . . T H <
# h . . B . . #
# h h . T h h #
# # # # # # # #
