8 11
# # # # # # # #
# h h . h h h #
# h . . T h h #
# T . . B T h #
# h . . . h h #
# h h . . . h #
# h . B . . h #
> . . . B . H <
# h . . B . . #
# h h . . . h #
# # # # # # # #
