8 11
# # # # # # # #
# h h h T . h #
# h h h . . h #
# h h . . . H <
# . T B B . . #
> . . . . T h #
# h h . B B h #
# h h . . . . #
# h h h . . . #
# h h h . . h #
# # # # # # # #
