8 10
# # # # # # # #
# h h . h h h #
# h . T . . h #
> B T T B T h #
# h . . . . . <
# h h . . . . #
# h h B . . h #
# h h . B . h #
# h h . . . h #
# # # # # # # #
