9 8
# # # # # # # # #
# h h . . h h h #
# T . T T . h h #
> . . . . . h h #
# h B . . . B H <
# h . . . B . B #
# h h h h . . . #
# # # # # # # # #
