6 11
# # # # # #
# h T . h #
# T . B h #
# . . . h #
# h . . h #
# h B . h #
# T . . H <
> . B . B #
# h . . . #
# h . . h #
# # # # # #
