9 7
# # # # # # # # #
# h h h h . . . <
# h h T h . B . #
# h . B . B . T #
> T B . . T h h #
# h . . . h h h #
# # # # # # # # #
