8 8
# # # # # # # #
# h T h . . h #
# T . . . . h #
# . . . . B H <
> . . B . B . #
# h h B T . h #
# h h . . h h #
# # # # # # # #
