7 10
# # # # # # #
# h h h . H <
# h h . . . #
# h h T . . #
# h . . . . #
# T . B B . #
> B . B . . #
# h . . . . #
# h T . . h #
# # # # # # #
