10 7
# # # # # # # # # #
# h h h h h . T h #
# . . B . . B T H <
> . . . B . B . . #
# h . . h h T . . #
# h h h h h . . h #
# # # # # # # # # #
