10 9
# # # # # # # # # #
# h h . h . h h h #
# h h . . . h h h #
# h h . T . h h h #
# . . B . . h h h #
> . . B B . . . H <
# h T . . . T B . #
# h h h h . . h h #
# # # # # # # # # #
