8 8
# # # # # # # #
# h h h . . h #
# h h h . . h #
# h h h B . . <
# h T T . T . #
# . B B B . h #
> . . T . h h #
# # # # # # # #
