9 8
# # # # # # # # #
# T . T B . h h #
# h B . . . . h #
> B . . . B . h #
# h h h . . . H <
# h h h . T . . #
# h h h h . . h #
# # # # # # # # #
