10 8
# # # # # # # # # #
# h T . . h h h h #
# . . B . . . . H <
# h . . . h . B . #
# . B . . T . . . #
> . . . T B . . . #
# h . . h h h h h #
# # # # # # # # # #
