10 6
# # # # # # # # # #
# T . B . . h h h #
# h . . . B B . . <
> . . . B . T T T #
# h h h h . . h h #
# # # # # # # # # #
