10 5
# # # # # # # # # #
# . . . . B . . H <
# B . . . B . T . #
> T B . . . . . T #
# # # # # # # # # #
