10 8
# # # # # # # # # #
# h h h h h . h h #
# h h h h . . . h #
# . . B . B . . H <
# . . T . . . B . #
# . . T h . . h h #
> B . T h h h h h #
# # # # # # # # # #
