9 8
# # # # # # # # #
# h . . h h h h #
# T . . h h h h #
> B . B . h h h #
# h . . . . B H <
# h . B . . T T #
# h h h . . h h #
# # # # # # # # #
