9 9
# # # # # # # # #
# . . . h . . H <
# . . . h B B . #
# . . . h . . . #
# T . . h . . . #
# . . . T . . B #
> B . T . h . . #
# h . h h h h h #
# # # # # # # # #
