7 10
# # # # # # #
# h . . . h #
# h . B . h #
# h . T B h #
# h B . . h #
# . . . B h #
> . . . . h #
# h . . T H <
# h T . . . #
# # # # # # #
