10 7
# # # # # # # # # #
# . . . . . h h h #
# . . . . B . . H <
# . . B B . . T . #
> . . . T T . B . #
# h . . h h h h h #
# # # # # # # # # #
