10 7
# # # # # # # # # #
# h h h h h . T h #
# h . . . . . . H <
# T . . . B B . . #
> . B . B . . T h #
# h . . h h h h h #
# # # # # # # # # #
