8 6
# # # # # # # #
# h . . . h h #
# T . B B . H <
> B . T . B . #
# h h T . h h #
# # # # # # # #
