7 11
# # # # # # #
# h . . T h #
# . B . . h #
> B . . . h #
# h . . . . <
# h T B B . #
# h . . . h #
# h . . . T #
# h . T . . #
# h h . h h #
# # # # # # #
