11 8
# # # # # # # # # # #
# h h h h h . . h h #
# . T . . . B . . h #
# h . B . B . . T h #
> B . . . . T . . . <
# h h h h h . . . . #
# h h h h h h T h h #
# # # # # # # # # # #
