10 10
# # # # # # # # # #
# h h . . h h h h #
# h . . B h . T H <
> . . . . . . B . #
# h . . . h B B . #
# h h h h h . . h #
# h h h . . . . h #
# h h h . . T h h #
# h h h . . T h h #
# # # # # # # # # #
