7 9
# # # # # # #
# h . . h h #
# . B . h h #
> B . B . H <
# h . T T . #
# h . B . . #
# h h . T h #
# h h . . h #
# # # # # # #
