8 8
# # # # # # # #
# h h h h . h #
# h h . T . H <
# h h . B T . #
# . . B B B . #
> . . . . T h #
# h . . h h h #
# # # # # # # #
