11 11
# # # # # # # # # # #
# h h . h h h h h h #
# h . . . h T . . h #
> B T . B . . . . . <
# h . . . h . . . h #
# h h . h h h h h h #
# h . . . h . . . h #
# h . . B . . . B h #
# h . . . . T . T h #
# h h . h h h h h h #
# # # # # # # # # # #
