7 11
# # # # # # #
# h . h h h #
# . . . h h #
# . T . h h #
# . . . h h #
# h . . h h #
# T B B . H <
> . . . . T #
# h . B B . #
# h . . h h #
# # # # # # #
