8 9
# # # # # # # #
# . . . h h h #
# . . T h h h #
> . B T . . h #
# h h T B B H <
# h h h . . B #
# h h h . . . #
# h h h h . h #
# # # # # # # #
