7 10
# # # # # # #
# h h . . h #
# h h B . h #
# h h . T H <
# . T . . . #
# B . . . h #
# T . . h h #
# . B B h h #
> . . . h h #
# # # # # # #
