11 8
# # # # # # # # # # #
# h h . . h h T . h #
# . B B . . . . . . <
> . B . . . T . T . #
# h h . . . h h h h #
# h h . T B h h h h #
# h h . . . h h h h #
# # # # # # # # # # #
