10 6
# # # # # # # # # #
# . T T . h h h h #
# . . B . . B T h #
> . B . . . B . H <
# h h h h . . . h #
# # # # # # # # # #
