9 10
# # # # # # # # #
# h h h T B . h #
# h h h . . . h #
# h h . T . . H <
# h . B . . . . #
# . B . . . h h #
> . . . h h h h #
# h . B h h h h #
# h T . h h h h #
# # # # # # # # #
