10 7
# # # # # # # # # #
# h h . . h h h h #
# h . T B h h h h #
> B . T . . . . H <
# h T . . . B B . #
# h h h h . . h h #
# # # # # # # # # #
