10 8
# # # # # # # # # #
# h h . . h h h h #
# . . . B B . . H <
> . . B . . T . . #
# h . . T h . . . #
# h . B . T h h h #
# h . . . h h h h #
# # # # # # # # # #
