6 8
# # # # # #
# . T . h #
# T T B h #
# . B . h #
# . B . H <
# . . B . #
> . . . h #
# # # # # #
