9 11
# # # # # # # # #
# h . h h h h h #
# . . . h h h h #
# . . . . h h h #
> . T B . . . H <
# h . h h B . . #
# h . . T . . . #
# h . . B . h h #
# h B . T h h h #
# h . . . h h h #
# # # # # # # # #
