7 8
# # # # # # #
# h T T . h #
# . B . . H <
> B . . . . #
# h . B . . #
# h . B . h #
# h . . T h #
# # # # # # #
