11 10
# # # # # # # # # # #
# h h h h . . . h h #
# h h h . . . . h h #
# h h h . B . . h h #
# h h . . h h . h h #
# h . B . h . . . h #
> . T B . . . B . H <
# h . . T h T . . h #
# h h h h h h . h h #
# # # # # # # # # # #
