9 9
# # # # # # # # #
# h h h . h h h #
# h h h . . h h #
# h h . . T T . <
# h h T . B B . #
# . . . B T h h #
> . . B . . h h #
# h . . h h h h #
# # # # # # # # #
