7 9
# # # # # # #
# h h . . H <
# h h B . . #
# h h . T . #
# h h . B . #
# . . . B . #
> T . B T . #
# h . . . h #
# # # # # # #
