11 7
# # # # # # # # # # #
# h h h T . h h h h #
# h . . B T . h h h #
> . B . B T . . . h #
# h . . . h . B . H <
# h h h h h . . . h #
# # # # # # # # # # #
