10 9
# # # # # # # # # #
# h h h h . . h h #
# h . B . . B . h #
# . . . . . . B h #
# . T T . . . . h #
> . . . h B . T h #
# h h h h . . . H <
# h h h h h h . . #
# # # # # # # # # #
