9 10
# # # # # # # # #
# T B . h . . H <
# . . . . . . . #
# T B . h . . T #
# h B h h . h h #
# . . B . . . h #
# . . . . . . . #
> . . . . . . h #
# h h h h . h h #
# # # # # # # # #
