9 8
# # # # # # # # #
# h h h h . . h #
# h h h h . . h #
# h . B . . . H <
> B . . B T . . #
# h . B . . T h #
# h h T h h h h #
# # # # # # # # #
