8 7
# # # # # # # #
# h h h h . H <
# . B . . B T #
# . T . B B . #
> . . . . . T #
# h h h h . . #
# # # # # # # #
