7 8
# # # # # # #
# h . . h h #
# . . B h h #
> . B . h h #
# h . . . h #
# h T B . H <
# h T B T h #
# # # # # # #
