8 9
# # # # # # # #
# h h h . T h #
# h h h . . h #
# h h h B . H <
# . . . . . . #
# T B . B . h #
> B . . . T h #
# h . . h h h #
# # # # # # # #
