6 10
# # # # # #
# . . . h #
# . B . . <
# . B . h #
# h T . h #
# . . . h #
> T . . h #
# h B . h #
# h . T h #
# # # # # #
