9 10
# # # # # # # # #
# h h h . h h h #
# h h . . . h h #
# h h . T . . h #
# . B T . B h h #
> . . . B T h h #
# h . . . . . . <
# h h h h . . . #
# h h h h . . . #
# # # # # # # # #
