7 9
# # # # # # #
# h T T . h #
> T . B . h #
# h . . . h #
# h h . . h #
# h . . B . <
# h . B . . #
# h . . . h #
# # # # # # #
