8 11
# # # # # # # #
# h h h h . h #
# h h h . . h #
# h h h T . h #
# h h h B . h #
# h h h . . h #
# . . T . . h #
# . . B . B . <
> . . T B . T #
# h h . . . h #
# # # # # # # #
