8 10
# # # # # # # #
# h h . . . h #
# h . . . . h #
# h h . . . h #
# h . B . . h #
# . . . . B h #
# . . . B T . <
> . . T T . . #
# h . . . . h #
# # # # # # # #
