10 8
# # # # # # # # # #
# h h h h . . h h #
# h . . . . T . h #
> . B T . . . . . <
# h . B T h . B B #
# h h h h . . . T #
# h h h h . . h h #
# # # # # # # # # #
