7 7
# # # # # # #
# h h T . h #
# . . . . h #
# T B B B . <
> . . . . . #
# h T . . h #
# # # # # # #
