8 9
# # # # # # # #
# h . . . . . <
# h . B . T . #
# h h . B T h #
# h h . . . h #
# h . B T . . #
> . . . . . . #
# h . . . . h #
# # # # # # # #
