9 6
# # # # # # # # #
# h h h h T . . <
# T . . . B B . #
> . . B T . . . #
# h . . h h h h #
# # # # # # # # #
