8 8
# # # # # # # #
# h . . h h h #
# . . . T h h #
> . . B B . h #
# h B . . . . <
# h . . . . T #
# h h T . h h #
# # # # # # # #
