11 11
# # # # # # # # # # #
# h h h h h h . h h #
# h . . . h . . . h #
# h T B . . . . . . <
# h T . . h . . . h #
# h . B . h h . h h #
> . T B . . . . . h #
# h . . . h . . . h #
# h h . h h . . . h #
# h h h h h h . . h #
# # # # # # # # # # #
