8 5
# # # # # # # #
# h . T T B . <
# . . B . . . #
> T . . B . . #
# # # # # # # #
