9 8
# # # # # # # # #
# h h . . h h h #
# . B . . . h . <
# . B . T . T . #
> . . T B . . . #
# h h . . . . . #
# h h h h . h . #
# # # # # # # # #
