8 6
# # # # # # # #
# h h T . h h #
# T . . B . . <
> . B . T B . #
# h h . . B T #
# # # # # # # #
