7 8
# # # # # # #
# . . T h h #
# T . . h h #
# . B . h h #
# . . B . . <
> B . . T . #
# h . . h h #
# # # # # # #
