8 7
# # # # # # # #
# h h h . T h #
# h . T B B . <
# . . . . T . #
> . . . B . h #
# h . . h h h #
# # # # # # # #
