7 7
# # # # # # #
# h h . . . <
# h h . B B #
# T B . B T #
> . T . . . #
# h . T h h #
# # # # # # #
