10 8
# # # # # # # # # #
# h h h . . . h h #
# h h h . . . . h #
# h h . . B T . . <
# . T . B . . . . #
# . B . h . . h h #
> . T . h h h h h #
# # # # # # # # # #
