8 7
# # # # # # # #
# h T . . . . <
# . B . . . . #
# . B . . . . #
> . B . . T h #
# h . T h h h #
# # # # # # # #
