8 10
# # # # # # # #
# h . . T . h #
# h . B B B h #
# h . T . T h #
# h h h . . . <
# . . . . . . #
# . T B . . h #
> . . . h h h #
# h . h h h h #
# # # # # # # #
