9 5
# # # # # # # # #
# . . . T . . . <
# . B . . B . . #
> . T . B . T h #
# # # # # # # # #
