11 6
# # # # # # # # # # #
# h . . . h . . . h #
> . . B . B . T . . <
# h . . . h B T . h #
# h h . h h T . h h #
# # # # # # # # # # #
