6 10
# # # # # #
# . T T h #
# T B . . <
# T B . h #
# h . B h #
# . . . h #
> . B . h #
# h . . h #
# h . . h #
# # # # # #
