9 7
# # # # # # # # #
# h T h h h h h #
# . B T h . . . <
# . . B B . . . #
> . . . T . B . #
# h . h h h T h #
# # # # # # # # #
