10 8
# # # # # # # # # #
# h T h h . . . h #
# . B . h . B . . <
# . . . . . B T h #
> T . . . . . h h #
# h . . . . . h h #
# h h . . h h h h #
# # # # # # # # # #
