6 7
# # # # # #
# h . . h #
# . B . h #
# . B . . <
# T . . . #
> T B T h #
# # # # # #
