7 10
# # # # # # #
# h . . h h #
# . . T h h #
# . B . . . <
# h . B . . #
# . T . . . #
> . . . . h #
# h T B h h #
# h . . h h #
# # # # # # #
