8 7
# # # # # # # #
# h . . . . h #
# . B B . . . <
> B . . . T . #
# h B T . h h #
# h T T h h h #
# # # # # # # #
