8 7
# # # # # # # #
# h h . . . . <
# h h . . B . #
# T . . . B . #
> T . B T . h #
# h . . h h h #
# # # # # # # #
