10 5
# # # # # # # # # #
# h h . . h . . . <
# . B T . . . . . #
> T B . B . T . . #
# # # # # # # # # #
