10 10
# # # # # # # # # #
# h h h h . . h h #
# h h h . . . h h #
# h h h . . B h h #
# h h h h . T h h #
# h h h h . . h h #
# h . . . . B . . <
> . . B T . T . . #
# h . . . . . . . #
# # # # # # # # # #
