6 8
# # # # # #
# . T h h #
> . T . . <
# h B B . #
# h . . . #
# h B . B #
# h T . T #
# # # # # #
