7 8
# # # # # # #
# h h . T h #
# h h . T h #
# h h B B . <
# T B . . . #
# . . . . h #
> . . . . h #
# # # # # # #
