8 7
# # # # # # # #
# h h h T . . <
# h h h . . . #
# . T . B B . #
# . B . T h h #
> . . . h h h #
# # # # # # # #
