10 9
# # # # # # # # # #
# h h . . h h h h #
# . . . T . h h h #
> . . T . . . . . <
# h h . B . B . . #
# h h . . . . B T #
# h h h . . h h h #
# h h h . . h h h #
# # # # # # # # # #
