7 8
# # # # # # #
# h h . h h #
# h . . . h #
# . T B . . <
# . . T . . #
> B . . B . #
# h . T h h #
# # # # # # #
