8 8
# # # # # # # #
# h . . h h h #
# . . T . . h #
> T T B . B . <
# h . . . B . #
# h . . . . . #
# h h . . h h #
# # # # # # # #
