8 10
# # # # # # # #
# h h h . . . <
# . . h . . . #
# B . . . B . #
# T . . T h h #
# . . . . h h #
> . T B . . h #
# h h . . . h #
# h h . . h h #
# # # # # # # #
