7 9
# # # # # # #
# h h . . h #
# h h . . h #
# h . . . . <
# . T B B T #
> B T . . h #
# h . B . h #
# h . T h h #
# # # # # # #
