7 7
# # # # # # #
# h . B T h #
# . . . . . <
> T B B . h #
# h T . h h #
# h . . h h #
# # # # # # #
