7 8
# # # # # # #
# h . . h h #
# . . . T h #
# T . . . h #
# . . . B . <
# B . . B T #
> B . . T h #
# # # # # # #
