5 7
# # # # #
# T B . <
# T B . #
# . . . #
# . B . #
> B T T #
# # # # #
