8 8
# # # # # # # #
# h h . . h h #
# T . B . . h #
> . . . . B . <
# h h T T B . #
# h h h . . . #
# h h h h . h #
# # # # # # # #
