10 8
# # # # # # # # # #
# h h . . h h h h #
# . . . . . . T h #
> . B T T . . . . <
# h h h . . . . . #
# h h h h . B B . #
# h h h h . . h h #
# # # # # # # # # #
