8 6
# # # # # # # #
# h T . B . h #
# . . T . . . <
> . T B B . h #
# h . . h h h #
# # # # # # # #
