8 6
# # # # # # # #
# h h . . h h #
# . . . . . . <
> . . B B B h #
# h T . T T . #
# # # # # # # #
