8 7
# # # # # # # #
# h h T B . h #
# h h T . . . <
# . B B . . h #
> T . B . . h #
# h . T h h h #
# # # # # # # #
