7 10
# # # # # # #
# h h . . . <
# h h T . B #
# h . . . T #
# h B . h h #
# . T B h h #
> . . . h h #
# h B . h h #
# h . T h h #
# # # # # # #
