10 9
# # # # # # # # # #
# h h h . T h h h #
# h h . . B h h h #
# h . . . . . h h #
# . . . . . . h h #
# . . . B . T . . <
> . . T . . B . . #
# h . . h h . . . #
# # # # # # # # # #
