10 5
# # # # # # # # # #
# . . . B T . . h #
# B B . B . . . . <
> T T . h T . . h #
# # # # # # # # # #
