11 8
# # # # # # # # # # #
# h h h h h h . T h #
# h h h h . . . . . <
# h . . B . . . . . #
> . . . . h T B . . #
# h . B . h . . . h #
# h h T h h h h h h #
# # # # # # # # # # #
