11 7
# # # # # # # # # # #
# h h h h h T B . . <
# h h . . h . . . . #
# . . B T . B . . h #
> . . . T . h h h h #
# h . . . h h h h h #
# # # # # # # # # # #
