8 7
# # # # # # # #
# h . T h h h #
# . . . B . . <
> T B . . B T #
# h T B . h h #
# h . . h h h #
# # # # # # # #
