7 8
# # # # # # #
# . T . h h #
# . B B h h #
> T . . . . <
# h h . . . #
# h h . B . #
# h h h . T #
# # # # # # #
