10 7
# # # # # # # # # #
# h h . . h . . h #
# . B T . T . . . <
> . . . . . . B T #
# h h . . . B . h #
# h h . . . h h h #
# # # # # # # # # #
