6 8
# # # # # #
# h . h h #
# T T . h #
# B B . h #
> . T B . <
# h B . . #
# h T . h #
# # # # # #
