7 7
# # # # # # #
# h h T . h #
# . B . T h #
# . B . B . <
> T . . B T #
# h h . . h #
# # # # # # #
