7 7
# # # # # # #
# T . B . h #
# . T . . h #
# . B . . . <
> . B . T . #
# h . . h h #
# # # # # # #
