7 7
# # # # # # #
# h h T T h #
# h . B . h #
> . . B . . <
# h . B B T #
# h h T . h #
# # # # # # #
