10 7
# # # # # # # # # #
# h . . . . . T h #
> . . . T B T B h #
# h . B . . B . . <
# h h h T . . . . #
# h h h h . . h h #
# # # # # # # # # #
