7 7
# # # # # # #
# h . . . . <
# . . . . B #
> B . B . T #
# h T . h h #
# h T . h h #
# # # # # # #
