10 11
# # # # # # # # # #
# h . T h h h h h #
# h . . h h h h h #
# h . B . h h h h #
# . . . . h h h h #
# . . . h h . h h #
# T . . h . . . h #
# B T . . . B . . <
> . . h h . B . h #
# h h h h h T h h #
# # # # # # # # # #
