9 7
# # # # # # # # #
# T . T h h h h #
# . B B h h h h #
> . . . . B . h #
# h h T . B . . <
# h h h . T . h #
# # # # # # # # #
