11 6
# # # # # # # # # # #
# h h . . h h h h h #
# . . . T B . B . . <
> B . . . B . T T h #
# h h h h . T . . . #
# # # # # # # # # # #
