11 9
# # # # # # # # # # #
# h h h h . . h h h #
# h h h h . T h h h #
# h h . . B B . h h #
# . . . T . T . h h #
> . T . . . B . B . <
# h h . . . . . . . #
# h h h h h . . h h #
# # # # # # # # # # #
