11 7
# # # # # # # # # # #
# h h h h h . . . h #
# . . B . . . . . H <
> . B . . T B . . . #
# h . T h . B . . T #
# h h h h h . . h h #
# # # # # # # # # # #
