8 10
# # # # # # # #
# h . . . h h #
# h T . . . h #
# . B B . h h #
> B . T B h h #
# h . . . . h #
# h T . . . . <
# h h T . . h #
# h h h . h h #
# # # # # # # #
