11 7
# # # # # # # # # # #
# h h . h h h . . h #
# h . B . . . . . . <
> B T T B . . B . . #
# h T T . h . . . h #
# h h . h h h . h h #
# # # # # # # # # # #
