10 7
# # # # # # # # # #
# h h . . T h h h #
# h h . . . . T . <
# . B . . . B . . #
> T T B . B . h h #
# h . . h h h h h #
# # # # # # # # # #
