9 9
# # # # # # # # #
# h h T . h h h #
# h h . . h h h #
# h . . B T h h #
# . . B . . h h #
# . T . B . . H <
> B . . . . . . #
# h . h . . h h #
# # # # # # # # #
