11 11
# # # # # # # # # # #
# h h h . h h h h h #
# h h . . . . . . h #
# h . . . . . . . h #
# h h . . B T . . h #
# h h . . h h h h h #
# h . . . h . . . h #
> B . . B . T B . H <
# h . T . h . . . h #
# h h h h h . . h h #
# # # # # # # # # # #
