10 7
# # # # # # # # # #
# h h h . . h h h #
# h T . B . . h h #
# . T . T . T . . <
> B . . B B . . . #
# h h h h . . h h #
# # # # # # # # # #
