10 9
# # # # # # # # # #
# . . . h h h h h #
# T . . h h . . h #
# . . T . . . T . <
> . T . B . B . . #
# h h h . B . . h #
# h h h B . . h h #
# h h h . . . h h #
# # # # # # # # # #
