11 7
# # # # # # # # # # #
# h h h h h . h h h #
# h . . T h . . h h #
> . . B . B B . . H <
# h . . . . . B . . #
# h . T h h . T h h #
# # # # # # # # # # #
