10 6
# # # # # # # # # #
# . . . . . . T h #
# . . B . B . T h #
> B . . B T . . . <
# h h h h h h T . #
# # # # # # # # # #
