9 8
# # # # # # # # #
# h h h h . . H <
# h h h h . B . #
# h . . T T . . #
# . B . . . h h #
> . . B B . h h #
# h T . h h h h #
# # # # # # # # #
