8 10
# # # # # # # #
# h h . T h h #
# . B . . . h #
# T . B B . h #
> . . . . B . <
# h h h . . T #
# h h . . . h #
# h h . . T . #
# h h . . . h #
# # # # # # # #
