6 11
# # # # # #
# h . h . <
# h T T . #
# . . . . #
> B . . B #
# h B . . #
# h . . . #
# h . B . #
# h . . . #
# h T h T #
# # # # # #
