8 7
# # # # # # # #
# . . T . B . <
# T . . B . T #
> B . . . B . #
# h h h h T . #
# h h h h . . #
# # # # # # # #
