11 9
# # # # # # # # # # #
# h h h h h h . h h #
# h h h h h . B T h #
# h . . . T B . . . <
# h . . . h . . T h #
# . B . . . h . h h #
> . B . . T . . . . #
# h . . h h . . . h #
# # # # # # # # # # #
