10 8
# # # # # # # # # #
# h h h h h . . . <
# h . . T h B . . #
> . . . . B . . . #
# h . . . h T B B #
# h . T h h . . . #
# h h h h h . h T #
# # # # # # # # # #
