7 10
# # # # # # #
# h h T . h #
# h . . . h #
# h B T T . <
# h . B . . #
# . B . . h #
> B . . h h #
# h . . h h #
# h T . h h #
# # # # # # #
