8 10
# # # # # # # #
# h h h . h h #
# h h . T . h #
# h . . . . . <
# h . . . . h #
# . B . . h h #
> T B . B . h #
# h B . . . h #
# h . T T . h #
# # # # # # # #
