7 11
# # # # # # #
# h . . . h #
# . . . . h #
# . . T B H <
# h . . . . #
# h B B . . #
# . B . h h #
> T . . h h #
# h . . h h #
# h . T h h #
# # # # # # #
