8 8
# # # # # # # #
# h h . . T H <
# . . . B . . #
# T . . . B . #
# . . . B B h #
> T . . . . h #
# h . . h h h #
# # # # # # # #
