10 7
# # # # # # # # # #
# h . T . h h h h #
# h . . . . . B . <
# . . . T . T . . #
> . B . . B . B . #
# h T . h h h h h #
# # # # # # # # # #
