9 9
# # # # # # # # #
# . . T h h . h #
# . . B h . . . <
# . . . B . . . #
# h h . B B . T #
# . . T . h h h #
# . . T h h h h #
> . . . h h h h #
# # # # # # # # #
