11 7
# # # # # # # # # # #
# T . h h h h h h h #
# . . T . h h . h h #
# . . . B B . . . h #
> . B . B . . . . . <
# h . T h h . T . h #
# # # # # # # # # # #
