7 11
# # # # # # #
# h h T h h #
# h . . . h #
# h . . . . <
# h T T B h #
# h h B . h #
# . . B . h #
# . . . . . #
> . T B . . #
# h h . . h #
# # # # # # #
