10 8
# # # # # # # # # #
# h . . . h h h h #
> B . . . B . . . <
# h . B B . . T T #
# h h . . . . . h #
# h h T T . . . h #
# h h h . . h h h #
# # # # # # # # # #
