11 10
# # # # # # # # # # #
# h h h . . . h h h #
# h h h B . . h h h #
# h h . . . . h h h #
# h h . . h h . h h #
# h . B . h . . T h #
> . T . B T B . . . <
# h T . . h . . . h #
# h h h h h h . h h #
# # # # # # # # # # #
