10 8
# # # # # # # # # #
# h h . . h . . h #
# . . . . . B . . <
# . . . B B . . T #
# . T T . h h h h #
# . . . B h h h h #
> T . . . h h h h #
# # # # # # # # # #
