7 9
# # # # # # #
# T . . h h #
# . T . T h #
> B . . B h #
# h h B . . <
# h . . . . #
# h . B T h #
# h . . . h #
# # # # # # #
