7 10
# # # # # # #
# h T h T h #
# h B . . h #
# h . . . h #
# . B B . h #
> . B . . h #
# h . . . . <
# h . . . . #
# h h T . T #
# # # # # # #
