8 9
# # # # # # # #
# h . . T h h #
# h . B . h h #
# T . . . h h #
> . B . h h h #
# h B B . . . <
# h . T . . . #
# h h . T . . #
# # # # # # # #
