10 7
# # # # # # # # # #
# h h h h . . . h #
# h h . B . . T h #
# . . B . . . . . <
# . T . B B . . . #
> T T . h . . h h #
# # # # # # # # # #
