10 6
# # # # # # # # # #
# h h T . h h h h #
# . B . . H . B H <
> . B T B T . . . #
# h . B T . B . . #
# # # # # # # # # #
