11 8
# # # # # # # # # # #
# h h h h h h . h h #
# h h h h h h . . h #
# h h h h h h . T h #
# . B . . B . . T . <
> B T T . . . B . . #
# h . . h h . . h h #
# # # # # # # # # # #
