11 7
# # # # # # # # # # #
# h h . h h . T h h #
# h . B . B . . . h #
> . . . B . B . . . <
# h T . . h . . . h #
# h h T h h . T h h #
# # # # # # # # # # #
