10 6
# # # # # # # # # #
# h . B . H . B H <
> B . . B T . T T #
# h . . B T . B . #
# h . . h h h h h #
# # # # # # # # # #
