10 6
# # # # # # # # # #
# . . B . T . . h #
# H T B B T B . H <
> . . B . B . . h #
# h h h h T . h h #
# # # # # # # # # #
