10 9
# # # # # # # # # #
# . . . h h . T h #
# . . B B . . . . <
> . . . . . . . . #
# h h . . T B h h #
# h h . . T . h h #
# h h h T B h h h #
# h h h . . h h h #
# # # # # # # # # #
