10 8
# # # # # # # # # #
# h . . T h h h h #
# . B . . h . . h #
> . . . . h . . H <
# h h . . B B . B #
# h h . . T . . T #
# h h h . . h h h #
# # # # # # # # # #
