7 11
# # # # # # #
# T . B . . <
# . . . . . #
# h T . h h #
# h B T h h #
# . B B h h #
> . . . . h #
# h . . . . #
# h . T . h #
# h h . h h #
# # # # # # #
