10 11
# # # # # # # # # #
# h h h h . . h h #
# h h h . T . . . <
# h h h T . . T . #
# h h h h . . . h #
# h h h h . B h h #
# h . B T h . . . #
> B . . . B . . . #
# h . . . h . . . #
# h h . h h h h h #
# # # # # # # # # #
