7 11
# # # # # # #
# h . . . . <
# . . B . . #
> B . T . h #
# h . T . h #
# h B . h h #
# h . . T h #
# h B . . h #
# h . . T h #
# h h . h h #
# # # # # # #
