11 8
# # # # # # # # # # #
# h h h h . . h h h #
# h h . B . . h h h #
# . . B . . . . h h #
> T . . B . B . . . <
# h h . . . . . T . #
# h h h T h T . h h #
# # # # # # # # # # #
