7 11
# # # # # # #
# h h . . h #
# T . T T h #
# . . . . . <
> B . B B . #
# h h . . h #
# h . . . h #
# h T . B h #
# h . . . h #
# h h . h h #
# # # # # # #
