11 9
# # # # # # # # # # #
# h h h h h . . h h #
# h h h h . B . h h #
# h h h h B . . h h #
# . . B . T T B h h #
> . T T . . . . . . <
# h . . h . . . . . #
# h h h h h . . h h #
# # # # # # # # # # #
