7 11
# # # # # # #
# h . . h h #
# . B . h h #
> T . . h h #
# h B . h h #
# h . . . . <
# h B B T T #
# h . . . . #
# h h T . . #
# h h . . h #
# # # # # # #
