10 10
# # # # # # # # # #
# h h h h . . . h #
# h h h h . . . . <
# . . . h T . T h #
# . B B h h . h h #
> . B . . . H . h #
# h h . . B . . . #
# h h h h T . . h #
# h h h h h . h h #
# # # # # # # # # #
