8 11
# # # # # # # #
# h h h . . h #
# h h . . . h #
# h . . . B . <
# h h . B . . #
# h h h . . h #
# h T . B B T #
> . . T . . T #
# h . . . . h #
# h h . h h h #
# # # # # # # #
