7 10
# # # # # # #
# h h . T H <
# h h . . . #
# h h . . . #
# h . B B T #
# . B . . B #
> . . . . . #
# h . T . h #
# h . . h h #
# # # # # # #
