7 10
# # # # # # #
# h . . h h #
# T . B h h #
> . . . h h #
# h . B . h #
# h . . . h #
# h B B . H <
# h T . . T #
# h . . . h #
# # # # # # #
