8 9
# # # # # # # #
# h h h . . h #
# h . B . . H <
# h . . B . . #
# h T . . T h #
> B . . B . . #
# h . . . . . #
# h h T . . h #
# # # # # # # #
