9 6
# # # # # # # # #
# h h . . h h h #
# T . B . . . . <
> B . . B T B . #
# h h h h T . T #
# # # # # # # # #
