8 9
# # # # # # # #
# . . . h h h #
# . . T . h h #
# . T . . . h #
# . . h . . h #
> . . T B B H <
# h B . . B . #
# h . . . . h #
# # # # # # # #
