7 11
# # # # # # #
# h h h . h #
# h . . B H <
# h . . . . #
# h h . . T #
# h . B B h #
# . T . . h #
> B . . . h #
# h . T . h #
# h . . h h #
# # # # # # #
