8 8
# # # # # # # #
# h . T . h h #
# . B . . h h #
> . B B B h h #
# h . . . . H <
# h . T . . . #
# h h h T . . #
# # # # # # # #
