9 9
# # # # # # # # #
# . . . h T B H <
# . . . h . . B #
> B . B . . T T #
# h h . . . h h #
# h . . . . h h #
# h . . . h h h #
# h . . . h h h #
# # # # # # # # #
