8 11
# # # # # # # #
# h . . . h h #
# . . . . . h #
# . . . . . . <
# h . B T . h #
# h . . B h h #
# h . B . h h #
> T . . T h h #
# h . . . h h #
# h h . h h h #
# # # # # # # #
