11 8
# # # # # # # # # # #
# h h . . h h h h h #
# T T . . . h T . h #
> . B . . B . . . H <
# h h . . B . B . . #
# h h h . . . h h h #
# h h h h . h h h h #
# # # # # # # # # # #
