8 9
# # # # # # # #
# h h . . h h #
# h T . . h h #
> . B T B . h #
# h . . . B h #
# h h h B T H <
# h h h . . . #
# h h h . . h #
# # # # # # # #
