7 9
# # # # # # #
# h . . . h #
# h T . T h #
# h B B T H <
# . . B . . #
> B . . h h #
# h . . h h #
# h . . h h #
# # # # # # #
