9 10
# # # # # # # # #
# h h h . . . h #
# h h . . . T h #
# h h h . . B h #
# h h h h h . h #
# . . B . T B . <
# . . . . T . . #
> . . . h T B . #
# h h h h h . h #
# # # # # # # # #
