8 10
# # # # # # # #
# h h h . . H <
# h h h . B . #
# h h . T . . #
# h . . . . h #
# h . . B B h #
# T . . . . . #
> . . h B . T #
# h h h . . h #
# # # # # # # #
