8 8
# # # # # # # #
# h h h . . H <
# h T . B . . #
# . B T . T . #
> B . . . h h #
# h B . . h h #
# h . . . h h #
# # # # # # # #
