7 10
# # # # # # #
# h h . . h #
# h h T . h #
# h h . B . <
# h . B . . #
# . B . . h #
# . . T B h #
> . T T . h #
# h . h h h #
# # # # # # #
