6 9
# # # # # #
# T . . h #
# B . . h #
# . . . h #
# . . B h #
# . . . . <
> . B . T #
# h T h h #
# # # # # #
