8 8
# # # # # # # #
# h h h T . h #
# h . B . B . <
# h T B . T . #
> T B . . h h #
# h . . . h h #
# h h . h h h #
# # # # # # # #
