8 11
# # # # # # # #
# h h h . . h #
# . . . . . h #
# . . . . . . <
> . T . . . . #
# h h B . . h #
# h . . B . . #
# h . T B . . #
# h h . . T h #
# h h . . h h #
# # # # # # # #
