10 7
# # # # # # # # # #
# h h . . h . . h #
# . B . . . . . h #
# . . . . T . B . <
> . . . B . . T . #
# h T . h . . h h #
# # # # # # # # # #
