7 5
# # # # # # #
# . . . T . <
# B B . B B #
> T . . T T #
# # # # # # #
