9 7
# # # # # # # # #
# . . . . . h . <
# . . . . B T . #
> B . T h . . . #
# h h h h . B . #
# h h h h . h T #
# # # # # # # # #
