8 9
# # # # # # # #
# h h . . h h #
# . . B . . h #
> . . B . . . <
# h h . B . . #
# h h . T T . #
# h h h . T h #
# h h h . . h #
# # # # # # # #
