7 9
# # # # # # #
# h . . . . <
# . . B . . #
# T B . . . #
# h . . h h #
# h B . . h #
> T T . . h #
# h . . . h #
# # # # # # #
