8 7
# # # # # # # #
# T . . h h h #
# . . . h h h #
> T B . . . . <
# h . B . B T #
# h h . . h h #
# # # # # # # #
