7 8
# # # # # # #
# . . . h h #
# . . B h h #
# B . T h h #
# . T . . . <
> T B . . . #
# h . . h h #
# # # # # # #
