8 7
# # # # # # # #
# h h . T T h #
# h . . B . . <
# . . . . B h #
> . T B . . h #
# h . . h h h #
# # # # # # # #
