8 8
# # # # # # # #
# h h h T h h #
# h h . . . h #
# h h T . B H <
# . T B . . . #
> B . . B . h #
# h . . h h h #
# # # # # # # #
