9 8
# # # # # # # # #
# h h . h h h h #
# h . . . h h h #
> . . B B . h h #
# h . T . . . . <
# h h h h T B T #
# h h h h T B . #
# # # # # # # # #
