7 9
# # # # # # #
# h h h . h #
# h . . . . <
# h . . B . #
# h h . B T #
# T . . . h #
# B . . h h #
> T . . h h #
# # # # # # #
