10 11
# # # # # # # # # #
# h h T h h h h h #
# h . B . h h h h #
> . . . . . h h h #
# h T . . h h h h #
# h h . . h . h h #
# h . . . B . . h #
# h . . . . . . . <
# h h . . . B . h #
# h h . T h . h h #
# # # # # # # # # #
