6 7
# # # # # #
# h . . . <
# . . . B #
> T B B . #
# h . B T #
# h T T h #
# # # # # #
