9 8
# # # # # # # # #
# . T . h h h h #
# . B . h h h h #
> . B . B T h h #
# h h . . B . . <
# h h T . T . . #
# h h h . . h h #
# # # # # # # # #
