10 6
# # # # # # # # # #
# . . T h h h h h #
# . . B h . . . h #
> B . . T . B B . <
# h h . . T . T h #
# # # # # # # # # #
