8 9
# # # # # # # #
# . . . . . h #
# . B . . . . <
# . . B . . h #
# h h . h h h #
# h . T . h h #
> . . B . . h #
# h T T . h h #
# # # # # # # #
