9 7
# # # # # # # # #
# h h h h . . h #
# h h T . . . . <
# T B B . . B T #
# . . . . h h h #
> B . T . h h h #
# # # # # # # # #
