8 10
# # # # # # # #
# h h T h h h #
# h . . . h h #
# . . B . . . <
# h B . . . . #
# . . B T h h #
> . T . h h h #
# h . . h h h #
# h . . h h h #
# # # # # # # #
