11 11
# # # # # # # # # # #
# h h . h h h h h h #
# h . . . h . . . h #
> . . . . . . . . . <
# h . . . h . . . h #
# h h . h h . . h h #
# h . . . h B T . h #
# h T . B . . . . h #
# h B . . h . . . h #
# h . . T h h h h h #
# # # # # # # # # # #
