8 9
# # # # # # # #
# h h h . . h #
# h h h . . h #
# h h h . . . <
# h h T B . . #
# . . B T . h #
# T B . h h h #
> . . . h h h #
# # # # # # # #
