5 8
# # # # #
# . . . <
# B B . #
# T . . #
# . T B #
# . B T #
> . . T #
# # # # #
