8 11
# # # # # # # #
# h h . h h h #
# h . . . h h #
> . . . . . h #
# h . T . . h #
# h h B . . h #
# h h T . T . <
# h h B B . . #
# h h . . . h #
# h h h . . h #
# # # # # # # #
