8 9
# # # # # # # #
# h h h h . h #
# h h . T B . <
# h . . B . . #
# . . . . . . #
> B T . h . h #
# h . . h h h #
# h . T h h h #
# # # # # # # #
