7 7
# # # # # # #
# h T B . . <
# . . B B . #
> T . . . . #
# h T B h h #
# h . T h h #
# # # # # # #
