11 7
# # # # # # # # # # #
# h h . . h h h h h #
# . B . B . . T . h #
> T . . . . . . . . <
# h . B T . . . . h #
# h h . . h h . h h #
# # # # # # # # # # #
