7 7
# # # # # # #
# h T B . h #
# h T . T h #
# . B B . . <
> . . . . . #
# h . . h h #
# # # # # # #
