11 7
# # # # # # # # # # #
# h h . . h h . h h #
# h . B . h . . . h #
> T . B . . T B . . <
# h . T . h . . . h #
# h h h h h h . h h #
# # # # # # # # # # #
