5 6
# # # # #
# T B . <
# T . . #
# B B T #
> . B T #
# # # # #
