8 6
# # # # # # # #
# h h T . . . <
# . T T . B . #
> B . . B . h #
# h . . h h h #
# # # # # # # #
