6 10
# # # # # #
# . . . h #
# . B B h #
# . T . . <
# h h . . #
# . . T . #
> B . T . #
# h T B . #
# h h . h #
# # # # # #
