9 8
# # # # # # # # #
# h h . . h h h #
# . . . . . h h #
> . . . B T . h #
# h . . . B . . <
# h h T . . . h #
# h h . B T h h #
# # # # # # # # #
