8 7
# # # # # # # #
# h h h h . h #
# . B T T . . <
# . B B B . . #
> . T . . . T #
# h h h h . h #
# # # # # # # #
