7 8
# # # # # # #
# h h . . h #
# h h . . h #
# . . . . . <
# B . T B . #
# . . B T h #
> T . . h h #
# # # # # # #
