5 7
# # # # #
# . . . <
# . . T #
# . B B #
# B . T #
> T . . #
# # # # #
