7 10
# # # # # # #
# . B T h h #
# . . . h h #
# . . . h h #
# h . B . h #
# h . T B h #
# h . . . . <
# . . . . T #
> . B T . h #
# # # # # # #
