5 7
# # # # #
# T . . <
# . . B #
# B . T #
> B T B #
# h h T #
# # # # #
