6 7
# # # # # #
# . . . h #
# T . B h #
# . B T . <
# B . B . #
> T . T h #
# # # # # #
