6 8
# # # # # #
# h . . . <
# h T B . #
# h B . T #
# h T B . #
# . . . . #
> . . h h #
# # # # # #
