10 9
# # # # # # # # # #
# h h h . . h h h #
# h h . . . h h h #
# h h . . B T . h #
# h h h . . . . . <
# . . . . B . . h #
> . B . T T . h h #
# h . . h h h h h #
# # # # # # # # # #
