8 7
# # # # # # # #
# . T . B . . <
# B . . . . . #
# . . . T . . #
> T . B . . h #
# h . . h h h #
# # # # # # # #
