8 7
# # # # # # # #
# h h h T . h #
# h . . B . . <
# h B T . B . #
> . T . . h h #
# h . . . h h #
# # # # # # # #
