7 7
# # # # # # #
# h h T . h #
# T B B . h #
# . . . . . <
> . . B . T #
# h h . . h #
# # # # # # #
