6 9
# # # # # #
# . . . h #
# . . T h #
> . B . h #
# h . B h #
# h . . . <
# h . B . #
# h T T h #
# # # # # #
