8 9
# # # # # # # #
# h h . . . h #
# h h T . . h #
# h . . . . h #
# . B B . . . <
> . T T B T . #
# h . B . h h #
# h . . h h h #
# # # # # # # #
