9 6
# # # # # # # # #
# h h . B . T . <
# . . . . . . . #
> T T B B . h h #
# h . . h h h h #
# # # # # # # # #
