8 8
# # # # # # # #
# h T . . h h #
# h B . . h h #
# . B . T h h #
> . T . T . . <
# h B . . B . #
# h . . . h h #
# # # # # # # #
