8 8
# # # # # # # #
# h T h h h h #
# T . . h h h #
# B T B h h h #
> B . . B . . <
# h T . . . . #
# h h . . h h #
# # # # # # # #
