10 10
# # # # # # # # # #
# . . h h h h h h #
> T B T . h T . H <
# h . . . B . . . #
# h . . . h . . . #
# h h h h h . B h #
# h h h . B . . h #
# h h h . . . h h #
# h h h . . . h h #
# # # # # # # # # #
