9 10
# # # # # # # # #
# h h h h . . H <
# h . h h B . B #
# . . T . . . . #
# . T . . B h h #
> . . B T . h h #
# h . h . . . h #
# h h h . . . h #
# h h h . . h h #
# # # # # # # # #
