7 9
# # # # # # #
# h . . h h #
# . B . h h #
> B . . B H <
# h . T T . #
# h . . . . #
# h h . B h #
# h h T . h #
# # # # # # #
