8 8
# # # # # # # #
# h h . . h h #
# T . . . h h #
# . . . B . h #
# B T . B . H <
> . B . . . . #
# h h . T h h #
# # # # # # # #
