9 9
# # # # # # # # #
# h h h h . T h #
# . B . . . . H <
# . . . . . B . #
> . B T . . . h #
# h h . T . B h #
# h h h . . . h #
# h h h h . h h #
# # # # # # # # #
