10 7
# # # # # # # # # #
# . h . h h T . h #
# . . B . B B . H <
# . T . T B . . . #
# . . . h . . . h #
> . h . h h h h h #
# # # # # # # # # #
