10 10
# # # # # # # # # #
# h h h h h h . h #
# h . T B . . . H <
# . . . . . . . B #
> T . . . . . . T #
# h . . . h h h h #
# h . B B h h h h #
# h . . . h h h h #
# h . . . h h h h #
# # # # # # # # # #
