7 9
# # # # # # #
# . . . h h #
# . . B h h #
> B . . . h #
# h . . . h #
# h h B B . <
# h h . T T #
# h h T T h #
# # # # # # #
