8 11
# # # # # # # #
# h h . h h h #
# h . . . h h #
# h . . . . h #
# h . B . h h #
# h h . . . h #
# h . . B . h #
# h . T B . . <
# . . . T . T #
> . . . . . h #
# # # # # # # #
