8 10
# # # # # # # #
# h h . . h h #
# h . . T h h #
# . . . . T h #
# h . . . . h #
# . . . B h h #
> B . B B . . <
# h T . . . . #
# h . . . T . #
# # # # # # # #
