8 10
# # # # # # # #
# h . . h h h #
# . B . h h h #
> B . . h h h #
# h . . h h h #
# h . B h T . <
# h h H . . . #
# h h T B . h #
# h h T . . h #
# # # # # # # #
