10 5
# # # # # # # # # #
# T . . . B . B H <
# . T . B . . . . #
> B . . . . . T . #
# # # # # # # # # #
