8 9
# # # # # # # #
# . . h h h h #
# . B h h h h #
# . . . B T h #
# . . . . . h #
> B . B . . H <
# h T . . . T #
# h h h . . h #
# # # # # # # #
