9 7
# # # # # # # # #
# h h . . h h h #
# . . B T . . h #
> B . . B B . H <
# h h h T T . h #
# h h h . . h h #
# # # # # # # # #
