9 8
# # # # # # # # #
# h h h h h . h #
# h h h h . . H <
# h h h . . T B #
# . B . T . . . #
> T B . . B . h #
# h . . h h h h #
# # # # # # # # #
