7 8
# # # # # # #
# T B T h h #
# . . T h h #
# . . . h h #
# . . B B H <
> B . . . . #
# h . . h h #
# # # # # # #
