9 9
# # # # # # # # #
# h h h . . h h #
# h h . . . . h #
# h h T B T . . <
# h h h . B T h #
# h h h . . h h #
> T B . B . h h #
# h . . . h h h #
# # # # # # # # #
