10 8
# # # # # # # # # #
# h h h h . T . h #
# h h h h . . B H <
# h h . B B . . h #
# T B . . . T . h #
> . . . . . h h h #
# h . . h h h h h #
# # # # # # # # # #
