10 7
# # # # # # # # # #
# h h h h h . . h #
# h h . . . . . H <
# h . . B T . . . #
> T B . B . h h h #
# h . B T h h h h #
# # # # # # # # # #
