8 8
# # # # # # # #
# h h h . . h #
# h . . . T . <
# h . B T . . #
# T B . T . . #
# B . B h h h #
> . . . h h h #
# # # # # # # #
