10 9
# # # # # # # # # #
# h h h h h . . . <
# h h h h h B . . #
# h . . B . T . . #
# . B . . . . h h #
> . B . . . . . T #
# h . . h h T . . #
# h h h h h T . . #
# # # # # # # # # #
