8 10
# # # # # # # #
# h . B . . H <
# h . . . T . #
# h . . . B . #
# h h . B h h #
# h . . . h h #
> . T . . . h #
# h . B T . h #
# h h . . h h #
# # # # # # # #
