7 8
# # # # # # #
# h h . T h #
# h h B T H <
# h h . B . #
# . . B . . #
> T B . . . #
# h . . h h #
# # # # # # #
