7 10
# # # # # # #
# h . T h h #
# . . . h h #
> B T . h h #
# h . . . h #
# h B . B h #
# h . B . H <
# h h . . T #
# h h . . h #
# # # # # # #
