10 9
# # # # # # # # # #
# h h h h h . . . <
# h h h h h B . B #
# h h h h h . . . #
# h h h h h . . . #
# h h T . h . . . #
# . B . . T . . T #
> . . B . T . h . #
# # # # # # # # # #
