10 7
# # # # # # # # # #
# h h . . h h h h #
# . T . B . h h h #
> T B . B . B . H <
# h h h . . . T . #
# h h h h . . h h #
# # # # # # # # # #
