6 10
# # # # # #
# h . . h #
# T . . h #
> B . B h #
# h . T h #
# h T B h #
# h . B H <
# h . . . #
# h . . . #
# # # # # #
