7 10
# # # # # # #
# h T . T h #
# h . . . h #
# h . B . h #
# h . B . h #
# h B B . h #
> T . . . H <
# h . . . h #
# h h . h h #
# # # # # # #
