10 9
# # # # # # # # # #
# h h . . h h h h #
# . . B . . B . H <
# . . . B . . . . #
# h . . . h . T . #
> . B T . . h . . #
# h . T . h h h h #
# h h . h h h h h #
# # # # # # # # # #
