9 8
# # # # # # # # #
# h h . . h h h #
# . B . . . h h #
> . . B . . h h #
# h B . . . B . <
# h . . T T . T #
# h h h h . . T #
# # # # # # # # #
