8 9
# # # # # # # #
# h h . T h h #
# h h . B h h #
# . B . . . h #
> B . B . T h #
# h . . . T . <
# h . . . . . #
# h h h T . h #
# # # # # # # #
