11 11
# # # # # # # # # # #
# h h . h h h h h h #
# h . . . h h h h h #
> . B . . h h . . h #
# h . . . T . T . H <
# h h h . . . B . . #
# h h h . . . h h h #
# h h h . . B h h h #
# h h h B . . h h h #
# h h h T h . h h h #
# # # # # # # # # # #
