10 11
# # # # # # # # # #
# h h h h . . h h #
# h T . . . . h h #
> B . . B . T . h #
# h . B . . . . h #
# h . . h . . h h #
# h h h h . . . h #
# h h h . . . . . <
# h h h h T B T h #
# h h h h h . h h #
# # # # # # # # # #
