9 9
# # # # # # # # #
# h h . . . h h #
# h h . B . . h #
# h h . . . . h #
# h h h h . . h #
# h . T . B B . <
> T . . B . . T #
# h T . . . . h #
# # # # # # # # #
