8 10
# # # # # # # #
# h h T h h h #
# h . . . h h #
# . T . . . h #
# h . T B B h #
# h h h . . h #
> . . B . . . <
# h . T B . . #
# h h h . . h #
# # # # # # # #
