7 11
# # # # # # #
# h h . . h #
# h h . . h #
# h h B . H <
# h h . T . #
# . B T . h #
# . T . B h #
> B . . . . #
# h h . . . #
# h h . . h #
# # # # # # #
