10 8
# # # # # # # # # #
# h h . h h h h h #
# h . . . h . . H <
> . . T . . . . . #
# h . . B B B . . #
# h . T B T . h h #
# h h . . h h h h #
# # # # # # # # # #
