10 7
# # # # # # # # # #
# h h . h h h h h #
# h . . . h h h h #
> . B . . B . . . <
# h T T B B . . . #
# h h . h . T . T #
# # # # # # # # # #
