11 7
# # # # # # # # # # #
# h T . T h h h h h #
> . T B B h . . . h #
# h T B . . . . . . <
# h h . . . B . . h #
# h h h . . h h h h #
# # # # # # # # # # #
