10 9
# # # # # # # # # #
# h T . . h h h h #
# h . . . h h h h #
# h . B . h h h h #
# h . . B h . T H <
> . . B . B T . . #
# h . . . h . . . #
# h h . h h h . . #
# # # # # # # # # #
