7 10
# # # # # # #
# h . . h h #
# . . B h h #
> B . . h h #
# h . . . . <
# h . B . T #
# h h . T B #
# h h . T . #
# h h . . T #
# # # # # # #
