8 9
# # # # # # # #
# h h h . . h #
# h . . B . h #
# h . . B T . <
# h h . . B . #
# T . . . B h #
> T . . . . h #
# h T . h h h #
# # # # # # # #
