7 11
# # # # # # #
# h . T h h #
# h B . h h #
# h . . . h #
# T B T B h #
# . . T . h #
> . . . . h #
# h . . B . <
# h h . . . #
# h h . . h #
# # # # # # #
