7 10
# # # # # # #
# h h T . h #
# h h . B h #
# h T . . . <
> . . . B . #
# h . B T h #
# h h . . . #
# h h B . T #
# h h . . h #
# # # # # # #
