7 10
# # # # # # #
# h T . h h #
# . . . h h #
# . . . . . <
# h B . T . #
# . B . B . #
> . . B h h #
# h T . h h #
# h T . h h #
# # # # # # #
