11 10
# # # # # # # # # # #
# h h . h h h h h h #
# h . T . h . . . h #
> . . B . B . . . . <
# h . . . h . . . h #
# h h . h h h . h h #
# h . B B . h h h h #
# h . T . . h h h h #
# h . T T . h h h h #
# # # # # # # # # # #
