8 11
# # # # # # # #
# h h h . T h #
# h h h . T h #
# h h h . . H <
# h h h . B . #
# . . . . T h #
# . B B . . h #
> . . . . . . #
# h h h B . . #
# h h h . . h #
# # # # # # # #
