9 10
# # # # # # # # #
# h . . . h h h #
# . . . B h h h #
# h . . . h h h #
# h h . B h h h #
# T . T B T . . <
# . . . h B . . #
> . . . h . . . #
# h h h h T . . #
# # # # # # # # #
