8 10
# # # # # # # #
# h h . . h h #
# h . . . h h #
# h . B B . . <
# h h . T . . #
# h h . T T T #
# . B . . . h #
# . . B h h h #
> . . . h h h #
# # # # # # # #
