10 9
# # # # # # # # # #
# h h . . h . . H <
# . B . T T . B . #
# . . . . . B . . #
# h . . . h h h h #
> B . . T . h h h #
# h . . . h h h h #
# h h . h h h h h #
# # # # # # # # # #
