8 11
# # # # # # # #
# h . h h h h #
# T . . h h h #
# . . . . h h #
# . . B h h h #
# h . . h h h #
# . . T T . . <
> B . B . . . #
# h B . . . . #
# h T . h h h #
# # # # # # # #
