7 7
# # # # # # #
# h . T h h #
# . B T B . <
> . . T . . #
# h . B . h #
# h . . h h #
# # # # # # #
