10 7
# # # # # # # # # #
# h h h h . . h h #
# h h . . B . . h #
# . T B . T T . . <
# . B . T B . . . #
> . . . h h h h h #
# # # # # # # # # #
