9 9
# # # # # # # # #
# h h T . h h h #
# h h B . h h h #
# h T . . T h h #
> . B . . . h h #
# h . . B . . . <
# h h . . . . . #
# h h h . . h h #
# # # # # # # # #
