8 10
# # # # # # # #
# h T B . h h #
# . . B . . h #
# . . . . . . <
# h . . . . . #
# h . T . h h #
# . . B T h h #
# . . . . . . #
> . . . . . h #
# # # # # # # #
