7 7
# # # # # # #
# . . . h h #
# . B T h h #
> . . T B . <
# h h . B . #
# h h . T . #
# # # # # # #
