7 11
# # # # # # #
# h h . h h #
# h . . T h #
# . . B . . <
> T . B . h #
# h . . h h #
# h . . h h #
# h B . . h #
# h T B . h #
# h T . h h #
# # # # # # #
