9 8
# # # # # # # # #
# h . . h h h h #
# . . B . T . . <
> . . . . . . h #
# h . T . . . . #
# h T B B h h h #
# h . . . h h h #
# # # # # # # # #
