8 8
# # # # # # # #
# h h h . . h #
# h . T . B . <
# . . T . . . #
# . B . . . B #
> . T B . . T #
# h . h h h h #
# # # # # # # #
