8 8
# # # # # # # #
# . . . h h h #
# B . B h h h #
> T . . . T h #
# h h T B B . <
# h h . . . h #
# h h h T h h #
# # # # # # # #
