8 10
# # # # # # # #
# h T . h h h #
# . B . h h h #
# . . . h h h #
# h . . h h h #
# h . . . h h #
# T B . . . . <
> . B . . . . #
# h h . . T h #
# # # # # # # #
