9 6
# # # # # # # # #
# h h h h . T h #
# . . B . . . . <
# B . . . . . . #
> T B . T h h h #
# # # # # # # # #
