8 7
# # # # # # # #
# h h h . . h #
# T . . . T . <
# B B . . B . #
> . . B T h h #
# h h T . h h #
# # # # # # # #
