7 7
# # # # # # #
# h h . . h #
# h h . . h #
# . . B . . <
# B B . B T #
> T . T T h #
# # # # # # #
