8 9
# # # # # # # #
# h . . h h h #
# . . B . h h #
> T B . . h h #
# h . . T h h #
# h . . . . . <
# h h h . . . #
# h h h . B T #
# # # # # # # #
