11 8
# # # # # # # # # # #
# h h . . h h h h h #
# . . B T . h . . h #
> . B . . . T . . . <
# h T . . B . . . . #
# h h . . . h h h h #
# h h h . h h h h h #
# # # # # # # # # # #
