5 8
# # # # #
# . . . <
# . . T #
# . B . #
# T B T #
# . B . #
> . . . #
# # # # #
