7 8
# # # # # # #
# . . T h h #
# . . B . h #
> . . . . h #
# h B . B . <
# h . T . T #
# h . . . h #
# # # # # # #
