10 10
# # # # # # # # # #
# h h h h . B T . <
# h h h h . . . . #
# . . . h . . . . #
# . . . h T h h h #
> . . . B . h h h #
# h h . B T h h h #
# h h . . . h h h #
# h h . h . h h h #
# # # # # # # # # #
