5 9
# # # # #
# h . . <
# . . . #
# . . . #
# B . T #
# . . B #
# T B . #
> T . . #
# # # # #
