7 11
# # # # # # #
# . h . h h #
# T B . h h #
# . . . h h #
# . . . h h #
> . h T h . <
# h h . B . #
# h h . . . #
# h h . B T #
# h h . h . #
# # # # # # #
