7 9
# # # # # # #
# h h . . h #
# h h . . h #
# . . B T . <
> . . T . . #
# h . . . h #
# h . B . h #
# h T B . h #
# # # # # # #
