11 6
# # # # # # # # # # #
# . . T . . h h h h #
> . . B . T B . . h #
# h . . h h . . . . <
# h h h h h . B T h #
# # # # # # # # # # #
