8 9
# # # # # # # #
# T B . h h h #
# . . T h h h #
> . B B T h h #
# h h . . . . <
# h h . . . . #
# h h . . . h #
# h h . . . h #
# # # # # # # #
