10 7
# # # # # # # # # #
# . . . h h h h h #
# T . . h h . . h #
# . B T . . . . . <
> . . B . B . T . #
# h . . h h h h h #
# # # # # # # # # #
