9 10
# # # # # # # # #
# . . . h T . . <
# . B . h B . . #
> . T . . . . . #
# h h . B T h h #
# h . . . . . h #
# h . T . . h h #
# h h B . h h h #
# h h . . h h h #
# # # # # # # # #
