11 8
# # # # # # # # # # #
# h h h h h h . h h #
# h h . . h . . . h #
# . B . . . T . . . <
> . . . . . . . B T #
# h . . B T . . . . #
# h h h h h . . h h #
# # # # # # # # # # #
