8 7
# # # # # # # #
# h T . B . . <
# . . . B . B #
> T B . . . T #
# h . T h h h #
# h . . h h h #
# # # # # # # #
