9 7
# # # # # # # # #
# h . . . . . h #
# . . . . . . . <
> T . . . B . . #
# h . . B B T . #
# h . . . T h h #
# # # # # # # # #
