7 10
# # # # # # #
# . . . h h #
# . B . h h #
> . . T h h #
# h . T . h #
# h . . . h #
# h . . . . <
# h . B . . #
# h . B T h #
# # # # # # #
