7 9
# # # # # # #
# h . . . h #
> T B . . . <
# h . B . h #
# h T . h h #
# h . T T h #
# h B . B h #
# h . . . h #
# # # # # # #
