10 8
# # # # # # # # # #
# h h h h h T . h #
# h h h . T . . . <
# T . . B . . B . #
# B . . . . . . h #
> B T . h . . . h #
# h . h h h h h h #
# # # # # # # # # #
