7 8
# # # # # # #
# T . . h h #
# . B . h h #
# . . . h h #
# B . . . . <
> B . T . . #
# h T . h h #
# # # # # # #
