5 8
# # # # #
# . . . <
# . . T #
# T . B #
# . . . #
# B B . #
> T . . #
# # # # #
