10 6
# # # # # # # # # #
# . . . h . . . h #
# T B T B . . . . <
> . . . T . B . . #
# h h h h . . h h #
# # # # # # # # # #
