7 8
# # # # # # #
# h T h h h #
# . B T . h #
# T B B . h #
> . . . . . <
# h h . . . #
# h h . . h #
# # # # # # #
