5 7
# # # # #
# . h . <
# T T . #
# B B . #
# . B . #
> . h T #
# # # # #
