11 7
# # # # # # # # # # #
# h h h h h h . . h #
# h . . . . B B T . <
> . . . . . . . . . #
# h B . . h . . T h #
# h T . h h h h h h #
# # # # # # # # # # #
