6 10
# # # # # #
# . B T h #
# . . . h #
> . . T . <
# h B . . #
# h . B h #
# h . . h #
# h . . h #
# h h T h #
# # # # # #
