8 8
# # # # # # # #
# h h . . . h #
# h h . . B h #
# . . . T . h #
# . B . T . . <
> B . . . T . #
# h h h . . h #
# # # # # # # #
