8 7
# # # # # # # #
# h h T . h h #
# . T B B . h #
> . . . . B . <
# h h h . . T #
# h h h . B T #
# # # # # # # #
