6 11
# # # # # #
# h h . h #
# h . T . <
# h . B B #
# h . . T #
# h h . h #
# . . . h #
# . B . h #
# . T . h #
> . . . h #
# # # # # #
