7 9
# # # # # # #
# h . . h h #
# T B . . . <
> . . . . . #
# h B B h h #
# h T . . . #
# h h T . B #
# h h . . T #
# # # # # # #
