9 10
# # # # # # # # #
# h h h h h . h #
# h h h h . . . <
# . . T . B B . #
> B . B T T . . #
# h T . h h h h #
# h . . . h h h #
# h . . . h h h #
# h . . . h h h #
# # # # # # # # #
