8 8
# # # # # # # #
# h . . h h h #
# T B . . . h #
# . B . . . . <
# B . . B . T #
> T T . . . h #
# h . . h h h #
# # # # # # # #
