6 7
# # # # # #
# h h T h #
# . . B . <
> . B . B #
# h T B T #
# h h T h #
# # # # # #
