6 9
# # # # # #
# h . . . <
# h . . . #
# h . . . #
# h B B . #
# . . T . #
# T . . . #
> B T . h #
# # # # # #
