5 10
# # # # #
# h h . <
# h . . #
# h . B #
# h . . #
# . . T #
> B . B #
# h . . #
# h T T #
# # # # #
