5 6
# # # # #
# T . . <
# . B . #
# B . . #
> B T T #
# # # # #
