8 5
# # # # # # # #
# h . . T . . <
# . B . B B T #
> B T T . . . #
# # # # # # # #
