9 8
# # # # # # # # #
# h h . h h h h #
# . . B T h h h #
> . . . . . h h #
# h . B B . . . <
# h h T h T B T #
# h h h h . . . #
# # # # # # # # #
