9 8
# # # # # # # # #
# h h . . h h h #
# . . . . T . h #
# . B T . . . . <
# . B B . . . . #
> . . . h . . . #
# h T h h h h h #
# # # # # # # # #
