5 10
# # # # #
# . . . <
# T B . #
# B . T #
# . . B #
# . T . #
# . . . #
> . . . #
# h . h #
# # # # #
