11 8
# # # # # # # # # # #
# h h . . h h h h h #
# . . . B . h . . h #
# . T . T T . . . . <
> . . B . . B . . . #
# h h . . . h h h h #
# h h h . h h h h h #
# # # # # # # # # # #
