7 9
# # # # # # #
# h T h h h #
# . B . h h #
# . B T . h #
> . . . . h #
# h . . . . <
# h h . B . #
# h h . T h #
# # # # # # #
