7 10
# # # # # # #
# T B . h h #
# T B . h h #
# B . . h h #
> . . . . h #
# h h T . h #
# h h T . . <
# h h B . . #
# h h . . h #
# # # # # # #
