6 9
# # # # # #
# h h T h #
# h . B . <
> . . . B #
# h . B T #
# h T . B #
# h . . . #
# h . . T #
# # # # # #
