10 10
# # # # # # # # # #
# h h h T B . . . <
# h h h . . . . . #
# h . h h . . h h #
# T B . h h . h h #
# . . B . . . . h #
> . . . . . . B h #
# h T . h h . T h #
# h h h h h . h h #
# # # # # # # # # #
