10 10
# # # # # # # # # #
# h . . h h h h h #
# h . . h h . . . <
# h . B T . . T . #
# h B . . h . . . #
# T . . . . B h h #
> . . . . . . . . #
# h . . h h . . . #
# h h h h h . . . #
# # # # # # # # # #
