10 9
# # # # # # # # # #
# h h h h h . . h #
# h . . . . . . . <
> B . . . . . . . #
# h T B B . h h h #
# h h h T T . h h #
# h h h . . . h h #
# h h h . . h h h #
# # # # # # # # # #
