9 8
# # # # # # # # #
# h h . T h h h #
# . T B . . h h #
> B . . . B . . <
# h h . . . . . #
# h h h T . . . #
# h h h . . h h #
# # # # # # # # #
