10 9
# # # # # # # # # #
# . . h h h h h h #
# . . . T h h h h #
# h B . B h h h h #
# . . T . . . . h #
> . . . . T . B . <
# h . . h h . . . #
# h h h h h . B T #
# # # # # # # # # #
