10 6
# # # # # # # # # #
# h h . . . . . . <
# . B T . B . . . #
> . . B . T . T . #
# h . . h h h h h #
# # # # # # # # # #
