9 9
# # # # # # # # #
# . . . . h h h #
# . . . B . . . <
# . . . . . . T #
# h h h h . . . #
# . . . B T . h #
# . . . . . h h #
> B T . . . h h #
# # # # # # # # #
