9 8
# # # # # # # # #
# h h . . h h h #
# . B T . h h h #
# . . . . . h h #
> T . . B . . . <
# h h . B . T . #
# h h h . . h h #
# # # # # # # # #
