9 8
# # # # # # # # #
# h h . T h h h #
# . . . B . . h #
> . . B T T . h #
# h h h . B . . <
# h h h . . B T #
# h h h h . . h #
# # # # # # # # #
