8 10
# # # # # # # #
# h h . h h h #
# h . . . h h #
> B . . . . h #
# h T B T h h #
# h h . h h h #
# h h . T . . <
# h h . B . . #
# h h . . . h #
# # # # # # # #
