7 9
# # # # # # #
# h h T B . <
# h h . B . #
# T . . . . #
# . . . h h #
# B . T h h #
# . . . h h #
> . . h h h #
# # # # # # #
