8 7
# # # # # # # #
# T T T h h h #
# B B B . h h #
> . . B . . . <
# h h h T . . #
# h h h . . . #
# # # # # # # #
