8 9
# # # # # # # #
# h h h . . h #
# h h h . . h #
# h h . . . . <
# h T B . B . #
> . T B . . h #
# h . . . h h #
# h h T h h h #
# # # # # # # #
