7 7
# # # # # # #
# . . . . h #
# . . . . h #
# . B B . . <
> . T B . T #
# h h . T h #
# # # # # # #
