9 5
# # # # # # # # #
# . . T T . B . <
# . . . B . B . #
> B T . . T . . #
# # # # # # # # #
