8 8
# # # # # # # #
# h h . h h h #
# h . . T h h #
> . T T B h h #
# h B B . T . <
# h . . . B . #
# h h . . h h #
# # # # # # # #
