8 7
# # # # # # # #
# T . . h h h #
# . . . h h h #
# T B B . B . <
> . . . . . . #
# h h T . h h #
# # # # # # # #
