9 8
# # # # # # # # #
# h h . . h h h #
# . . . . . . . <
> T T . B B . . #
# h h h T . . . #
# h h h h B . h #
# h h h h . . h #
# # # # # # # # #
