7 10
# # # # # # #
# h . . . . <
# h . . B . #
# h . T T . #
# . . B h h #
> . . . . T #
# h . B . B #
# h . . . . #
# h h h T h #
# # # # # # #
