9 8
# # # # # # # # #
# h h T . . h h #
# h h . . . h h #
# . . . . . . h #
> . . T . T B . <
# h . B B . . . #
# h h h . . h h #
# # # # # # # # #
