9 7
# # # # # # # # #
# h h h . . T h #
# h h . B . . . <
# . . . . T B . #
> . . B . . h h #
# h . T h h h h #
# # # # # # # # #
