7 10
# # # # # # #
# h h T h h #
# h T B . h #
# . . B . . <
# h . . . h #
# h h . h h #
# . . . h h #
# B B . . h #
> T T . h h #
# # # # # # #
