7 9
# # # # # # #
# h . . h h #
# . T . . . <
> . B T . . #
# h . B . . #
# h . . B . #
# h h . . . #
# h h T . . #
# # # # # # #
