11 10
# # # # # # # # # # #
# h h . h h h h h h #
# h . . . h h h h h #
> T B . . . h h h h #
# h . T . h . . . h #
# h h . h h . . . . <
# h . . T . . . . h #
# h B B B . h h h h #
# h T . . . h h h h #
# # # # # # # # # # #
