10 9
# # # # # # # # # #
# h h h h h T B . <
# h h h h h . . . #
# h h T . . B . . #
# . . . . . . h h #
> B . . . . T . . #
# h h h h h . . . #
# h h h h h . . . #
# # # # # # # # # #
