10 8
# # # # # # # # # #
# h h h h h . h . <
# . . h h h . . . #
# . . . . h . B . #
# . T . . B . T T #
> . . . B . . h . #
# h . . h h h h h #
# # # # # # # # # #
