8 9
# # # # # # # #
# h . . h h h #
# . . . . h h #
> T . B T . h #
# h B . . h h #
# h . . . . . <
# h h h . . . #
# h h h . B T #
# # # # # # # #
