8 7
# # # # # # # #
# h h h . . h #
# h . T T . . <
# h . B B B . #
> . . . . . h #
# h T . . h h #
# # # # # # # #
