9 8
# # # # # # # # #
# h . . h h h h #
# T . . h . . h #
> . . . B T . . <
# h . . B B . . #
# h . . T . . h #
# h h h . . . h #
# # # # # # # # #
