9 7
# # # # # # # # #
# h h h h h . h #
# h h h h T B . <
# . B . T . . . #
> T B . . . . . #
# h . . h h . h #
# # # # # # # # #
