10 9
# # # # # # # # # #
# h h h h h . . . <
# h h . . h . . . #
# . . . T . B . . #
> T B . . . . B . #
# h . . . h . T T #
# h . . . h . . B #
# h h h h h . . . #
# # # # # # # # # #
