9 8
# # # # # # # # #
# T B . h h h h #
# T B T h h h h #
> T . . . . . h #
# h h . B B . . <
# h h h . . . h #
# h h h . . h h #
# # # # # # # # #
