8 6
# # # # # # # #
# h . B T h h #
> . B . . . . <
# h T . B T . #
# h h . . h h #
# # # # # # # #
