11 7
# # # # # # # # # # #
# h h T . h h . h h #
# h . B B . T . . h #
> . . . T . . . . . <
# h . . . B . . . . #
# h h h h h . . h h #
# # # # # # # # # # #
