10 7
# # # # # # # # # #
# h h T h h h h h #
# h T . T h h h h #
# . . B . . B . h #
> . . B . . . . . <
# h . . h h h h h #
# # # # # # # # # #
