10 8
# # # # # # # # # #
# h h h h h . . . <
# h h h h h . B . #
# h . T T . B . . #
> T . B . . . h h #
# h . B . h h h h #
# h h T h h h h h #
# # # # # # # # # #
