7 7
# # # # # # #
# h h . . h #
# T . T . . <
# . . . B . #
# B . . . h #
> B T . h h #
# # # # # # #
