6 10
# # # # # #
# . . T h #
# . . . h #
# . B . h #
# h . T h #
# h B B . <
> T . . . #
# h . . . #
# h h . h #
# # # # # #
