7 7
# # # # # # #
# h h . . h #
# T B . B h #
# . T . B . <
# . . . T . #
> B . . T h #
# # # # # # #
