6 9
# # # # # #
# h . . . <
# h . B . #
# h . . T #
# . . B h #
> . B T h #
# h B . h #
# h T T h #
# # # # # #
