7 9
# # # # # # #
# h h . T h #
# h h B . h #
# h . . T . <
# h . B T . #
# . . . . . #
> . . B . . #
# h . . h h #
# # # # # # #
