8 7
# # # # # # # #
# h h h T . h #
# h . . . B . <
# . . B B T . #
> B . . T T h #
# h . . h h h #
# # # # # # # #
