8 9
# # # # # # # #
# h h h T . h #
# h h h B . h #
# h h h T . . <
# h h . . . . #
# h . B B . h #
> . T B . T h #
# h . . . h h #
# # # # # # # #
