10 7
# # # # # # # # # #
# . B T h h h h h #
# . . T h . . T h #
> T B . . B . B . <
# h h . . . . . h #
# h h h h h . h h #
# # # # # # # # # #
