9 7
# # # # # # # # #
# h h . T h h h #
# . T . . . h h #
> B T B T B . h #
# h h . . B . . <
# h h h . . . h #
# # # # # # # # #
