8 9
# # # # # # # #
# h h h . T h #
# h h h T B h #
# h h h . . . <
# h h h B . . #
# h . . B T h #
> . . B . h h #
# h T . . h h #
# # # # # # # #
