5 7
# # # # #
# h . . <
# . B . #
> B . T #
# h B T #
# h T . #
# # # # #
