10 8
# # # # # # # # # #
# h h . . h h h h #
# . . . . . . . h #
# . B B . . . . . <
> . B . . T . . . #
# h . T . h h . . #
# h . T . h h . h #
# # # # # # # # # #
