8 8
# # # # # # # #
# h h h . . h #
# h h h B . h #
# h h h . . . <
# . T B . . . #
# . T . . . h #
> B . . T h h #
# # # # # # # #
