9 7
# # # # # # # # #
# h h . . . h h #
# T B . T T h h #
> . . B . B . . <
# h . . h . . . #
# h h h h . . . #
# # # # # # # # #
