9 9
# # # # # # # # #
# h h . . h h h #
# h . T . . h h #
# h . T . . . h #
# h h . T . . . <
# . . . B . . h #
# . B B h . h h #
> . . . h h h h #
# # # # # # # # #
