10 8
# # # # # # # # # #
# h h . . h h h h #
# . T . B . . h h #
# B B . T . . . h #
# . . . . . . . . <
# T . . h . . . h #
> T B . h h . h h #
# # # # # # # # # #
