8 6
# # # # # # # #
# h T . T . . <
# . . B B B T #
> . . . B T h #
# h . . h h h #
# # # # # # # #
