7 10
# # # # # # #
# h h . . h #
# . . . . h #
# . B . T . <
# . T . . . #
# T . . B h #
# . B . . h #
# . . . h h #
> . . . h h #
# # # # # # #
