10 6
# # # # # # # # # #
# h h h h . . . h #
# . . . . . . . . <
# B T B . . B . h #
> T T . . h h h h #
# # # # # # # # # #
