8 6
# # # # # # # #
# h h h . . . <
# . . B T . . #
> . T B B . . #
# h . T h h h #
# # # # # # # #
