11 7
# # # # # # # # # # #
# h h . h h h h h h #
# h T . . h h h h h #
> . T B . B . . . . <
# h . T . . B . . . #
# h h h h h . . h h #
# # # # # # # # # # #
