7 5
# # # # # # #
# T B . . . <
# . B . B T #
> B . . T T #
# # # # # # #
