8 5
# # # # # # # #
# T . T . . H <
# h B . B B . #
> B . T . . . #
# # # # # # # #
