6 8
# # # # # #
# . B T h #
# . . . . <
# . . B h #
# . . . h #
# . . T h #
> T B . h #
# # # # # #
