7 8
# # # # # # #
# h h h T h #
# h . B . . <
# . . . . . #
> T B B . . #
# h . . . h #
# h T . . h #
# # # # # # #
