7 8
# # # # # # #
# h . . h h #
# . B T h h #
> . T . . . <
# h T . B . #
# h . B . . #
# h . . h h #
# # # # # # #
