10 6
# # # # # # # # # #
# . T . . . . . . <
# h . B . h . T T #
> B . . . B B . . #
# h h h h h . . T #
# # # # # # # # # #
