9 9
# # # # # # # # #
# h h . h . . h #
# h . . B . B h #
> . . . . . B . <
# h . . . B . T #
# h h . . . . h #
# h h h T T . h #
# h h h . T . h #
# # # # # # # # #
