8 11
# # # # # # # #
# h T . h h h #
# . B . h h h #
> B . . h h h #
# h . B . h h #
# h . B . . . <
# h . . T . . #
# h . . . . . #
# h h . T h h #
# h h . T h h #
# # # # # # # #
