11 8
# # # # # # # # # # #
# h h h h h . . . h #
# h h h h h . . . . <
# h h . h h B . . h #
# h . . T . . . B . #
> . T . . B . B . . #
# h T T . h . . h h #
# # # # # # # # # # #
