7 10
# # # # # # #
# T . . T h #
# . . . . h #
# T . B T . <
# h h . B . #
# h . . B h #
> . B . . . #
# h . . . h #
# h h . h h #
# # # # # # #
