10 6
# # # # # # # # # #
# h T . . h . . H <
> . B T B . . B . #
# h . B . . B . T #
# h T . h h h h h #
# # # # # # # # # #
