11 9
# # # # # # # # # # #
# h . . h h h h h h #
# h B . h h h . . h #
# h . B . B . . . . <
# . . . . . T . T . #
> . . B . . h T . . #
# h T . h h h h . . #
# h h h h h h h . . #
# # # # # # # # # # #
