10 6
# # # # # # # # # #
# h h . . h h h h #
# T . . B . . T H <
> B T B B B H . B #
# h . . T . . . . #
# # # # # # # # # #
