10 7
# # # # # # # # # #
# . . . h h . . h #
# . . B B T . . . <
> . . T . . . . . #
# h . T . B . . . #
# h h . . h h h h #
# # # # # # # # # #
