11 7
# # # # # # # # # # #
# h h h h h . . h h #
# h . B T . . . . h #
> . . . B . . T . . <
# h . T B . B T . . #
# h h . . h h h h h #
# # # # # # # # # # #
