8 5
# # # # # # # #
# . T T . B . <
# T B . . B . #
> . B T . . . #
# # # # # # # #
