7 8
# # # # # # #
# h . T B . <
# h . . B . #
# . . . T . #
> . B T h h #
# h . B h h #
# h . T h h #
# # # # # # #
