5 8
# # # # #
# . . . <
# T . B #
# . . . #
# . B T #
# B . T #
> B T . #
# # # # #
