5 9
# # # # #
# . T . <
# T B . #
# . . T #
# B B . #
# . . . #
# . . . #
> T B . #
# # # # #
