7 10
# # # # # # #
# h h . h h #
# h . . . h #
> B T . . h #
# h . B . h #
# h h T B h #
# h h . . . <
# h h . T . #
# h h . . h #
# # # # # # #
