8 9
# # # # # # # #
# h h . . h h #
# h h B . h h #
# h . . . . h #
# h . . T T h #
# . . B T . . <
> . . . . B . #
# h . . . . h #
# # # # # # # #
