9 8
# # # # # # # # #
# h h . . . h h #
# h . T B . T h #
# h h . . . h h #
# . . . . . . . <
# B . B h . . . #
> T . . h . . . #
# # # # # # # # #
