8 7
# # # # # # # #
# h h T . h h #
# T B . T . h #
> . B . . B . <
# h h . . . . #
# h h . B T h #
# # # # # # # #
