7 5
# # # # # # #
# h h T . h #
# T B B . . <
> . . B . T #
# # # # # # #
