7 8
# # # # # # #
# . . T . . <
# . . . . T #
# T . B h h #
# . . . h h #
# B . B h h #
> . . . h h #
# # # # # # #
