9 8
# # # # # # # # #
# h h h h . . h #
# h T . B T B . <
# . B T . . . T #
# . . B . h h h #
> . . . . h h h #
# h . h h h h h #
# # # # # # # # #
