8 7
# # # # # # # #
# h h T . h h #
# . . . . T h #
> B . B . . . <
# h h . . B . #
# h h h . T . #
# # # # # # # #
