10 7
# # # # # # # # # #
# h h . . h h h h #
# . B . . T h h h #
> . . . . B T B . <
# h h h . . . T . #
# h h h . . . . . #
# # # # # # # # # #
