8 7
# # # # # # # #
# h h h . . h #
# h . . . B . <
# h B . . . T #
# T . . . . h #
> . . B . T h #
# # # # # # # #
