9 7
# # # # # # # # #
# h h h h . h h #
# . B T . . . h #
# . B . . . . . <
> B . . T T . h #
# h h h h . h h #
# # # # # # # # #
