9 8
# # # # # # # # #
# h T h h h h h #
# . . . . . h h #
# . B . . . h h #
> . . . . . . . <
# h . B B T . T #
# h h h . . h h #
# # # # # # # # #
