8 10
# # # # # # # #
# h . . . . . <
# h h . B . h #
# h . . T . . #
# h . . . h h #
# h h . . h h #
# h h B . h h #
# T . . . . h #
> . . . B T h #
# # # # # # # #
