7 10
# # # # # # #
# h . . T h #
# T . . B h #
# h . B . h #
# h h . . h #
# h . B . h #
> . . . . . <
# h . T . . #
# h h . . h #
# # # # # # #
