11 8
# # # # # # # # # # #
# h T . . h h . . h #
# h B . . B T . . . <
# h . . B . . B . T #
# h . . T h . . . h #
# . . . . h h h h h #
> . . . . h h h h h #
# # # # # # # # # # #
