8 8
# # # # # # # #
# h h h . . h #
# h h . B T h #
# . . . T . . <
> . . B B . . #
# h . . . T h #
# h . . . h h #
# # # # # # # #
