7 9
# # # # # # #
# h h T T h #
# h . B B . <
# h . . . . #
# T . . B . #
> T . . . h #
# h . B h h #
# h . . h h #
# # # # # # #
