8 7
# # # # # # # #
# h h h . T h #
# . . T . B . <
# . . B . . . #
> . . T B h h #
# h h . . h h #
# # # # # # # #
