8 8
# # # # # # # #
# h h h . . h #
# . . . . . . <
# . . B . . . #
> . . . . T . #
# h h h B B T #
# h h h . T . #
# # # # # # # #
