10 8
# # # # # # # # # #
# h h . . . h h h #
# h h . . . B . h #
# h h . T . T . . <
# . B . T . B . . #
# . . . h . . h h #
> . . . h h h h h #
# # # # # # # # # #
