10 8
# # # # # # # # # #
# h h . . h . . . <
# . . . . B . . . #
> B T . . T T . . #
# h h . . . B h h #
# h h h . . . h h #
# h h h h . h h h #
# # # # # # # # # #
