8 7
# # # # # # # #
# h h . . T h #
# h . . B . h #
> . . B T . . <
# h . B . B T #
# h h h T . h #
# # # # # # # #
