9 7
# # # # # # # # #
# h . . h T . . <
# . . . h . B . #
# B . T . . B . #
> T . . . . h h #
# h . . h h h h #
# # # # # # # # #
