7 10
# # # # # # #
# h h . . . <
# h h . . . #
# h h . . . #
# h . . B h #
# . . T T h #
> B . B . h #
# h . T . h #
# h . . h h #
# # # # # # #
