7 10
# # # # # # #
# . . . h h #
# . B . h h #
# . . T h h #
# . . B . h #
# h h . . h #
# . T . T . <
# . . . B . #
> . . . . h #
# # # # # # #
