11 7
# # # # # # # # # # #
# h h . h h . . . h #
# . . . B T T B . . <
> . . . . . . . . h #
# h . . B B . . . h #
# h h . h T T h h h #
# # # # # # # # # # #
