7 6
# # # # # # #
# T T T h h #
# . B B . . <
> . B . . . #
# h . . h h #
# # # # # # #
