10 9
# # # # # # # # # #
# h h h h h . h h #
# T . h h T . . h #
# B . . . . . . . <
# . B . . . . . . #
> . . B . . . . h #
# h h T . . . . h #
# h h h . . h h h #
# # # # # # # # # #
