6 8
# # # # # #
# h T B . <
# h . . . #
# h T B . #
# h B . . #
> B . T T #
# h . . . #
# # # # # #
