6 5
# # # # # #
# T T . . <
# B B . . #
> T . B . #
# # # # # #
