7 10
# # # # # # #
# h . . . h #
# . . . B h #
> B T . T . <
# h . . . . #
# h T . . h #
# h . . B h #
# h h . . h #
# h h . . h #
# # # # # # #
