5 8
# # # # #
# h . h #
# . . . <
# . B . #
# B B . #
# T T T #
> B T . #
# # # # #
