10 8
# # # # # # # # # #
# h h h h h . . . <
# h . . . h . . B #
# . B B . . . . . #
> . . T . . B T T #
# h T . . . . . . #
# h h h h . . h h #
# # # # # # # # # #
