7 9
# # # # # # #
# h . . T h #
# T . B B . <
> T T . . h #
# h . B h h #
# h . . B . #
# h h . . . #
# h h . . . #
# # # # # # #
