7 9
# # # # # # #
# h . . . h #
# T . . . . <
> . . B . T #
# h . . B h #
# h T . . h #
# h B . . h #
# h . . . h #
# # # # # # #
