8 10
# # # # # # # #
# h . . h h h #
# . . . . h h #
# T . . B T h #
# h . . T . . <
# . . . B . h #
> . B . . h h #
# h . . h h h #
# h . . h h h #
# # # # # # # #
