8 8
# # # # # # # #
# . . . h h h #
# . B . h h h #
# . B T T h h #
> . . T . B . <
# h h h B . . #
# h h h T . . #
# # # # # # # #
