7 10
# # # # # # #
# . . B T h #
# . . . . h #
# . . . . h #
# h B . B h #
# . . T T h #
> . . . . . <
# h . T B . #
# h . . . h #
# # # # # # #
