7 8
# # # # # # #
# h h . h h #
# h . . . h #
# . . T B h #
# . B . B . <
> . T B T T #
# h . . h h #
# # # # # # #
