7 10
# # # # # # #
# h . . h h #
# . T . h h #
# . . . h h #
# h B B h h #
# h T . . h #
> T . B . . <
# h . B T h #
# h h . h h #
# # # # # # #
