7 8
# # # # # # #
# T . . h h #
# B T . h h #
> B . . h h #
# h T . B . <
# h h . B T #
# h h . . . #
# # # # # # #
