7 8
# # # # # # #
# h . . h h #
# . . . . h #
> B T B . . <
# h . . B . #
# h . B T T #
# h h h T h #
# # # # # # #
