9 9
# # # # # # # # #
# h h h h . . h #
# h h h h . . h #
# h h . . T T . <
# . . . B . . . #
> . B . T B . h #
# h h h . . . h #
# h h h . . . h #
# # # # # # # # #
