7 11
# # # # # # #
# h . . h h #
# . B . . h #
# . T . . h #
# h . B . . <
# h . . . . #
# T T . . h #
> . . . . h #
# h B . h h #
# h . . h h #
# # # # # # #
