8 9
# # # # # # # #
# h h . . . h #
# h h . B . h #
# h h . . . h #
# h h B . . . <
# . . T . B T #
# . . . . T h #
> . . . h h h #
# # # # # # # #
