5 7
# # # # #
# T h . <
# . . . #
# . . B #
# B B T #
> . h T #
# # # # #
