7 9
# # # # # # #
# h h . . h #
# T . . . h #
# B . T h h #
> B . . h h #
# h T . . . <
# h h B . . #
# h h . . . #
# # # # # # #
