10 9
# # # # # # # # # #
# h . T . h h T . <
> T B . . . . B . #
# h . . . h . . . #
# h . B h h h . . #
# h . . . . h . . #
# h h . . . h h h #
# h h . . . h h h #
# # # # # # # # # #
