11 6
# # # # # # # # # # #
# h h T . h h h h h #
# . . . . . . T . h #
> . . T . B B B . . <
# h . . . h . . . h #
# # # # # # # # # # #
