7 6
# # # # # # #
# h h T T h #
# . . B . . <
> . B B . T #
# h . . . . #
# # # # # # #
