7 10
# # # # # # #
# h . . h h #
# . . . T h #
# . . . . . <
# h . B B T #
# . . . . . #
> . . . . h #
# h . B h h #
# h T . h h #
# # # # # # #
