5 9
# # # # #
# . . . <
# . . B #
# . . . #
# T T T #
# . . . #
# B B . #
> . . . #
# # # # #
