11 8
# # # # # # # # # # #
# h h h h h h . h h #
# h h h h h . . . h #
# h h h h T . . . . <
# . . . . . B . T . #
> . B T . B . . . . #
# h . . h h . . h h #
# # # # # # # # # # #
