10 10
# # # # # # # # # #
# h h h . . h h h #
# h h h T . h h h #
# h h h . . . h h #
# h h h . . . h h #
# h h T . . . . . <
# . B B B . . . . #
# . . . h T . h h #
> B T . h h h h h #
# # # # # # # # # #
