6 10
# # # # # #
# h h . h #
# h . . . <
# h . . . #
# h B B . #
# . . T h #
# . . . h #
# T . . h #
> B T . h #
# # # # # #
