10 6
# # # # # # # # # #
# h h h h . T . h #
# . B . . B . B H <
# T T B . B T . . #
> . . . H B . h h #
# # # # # # # # # #
