10 6
# # # # # # # # # #
# h h . . h H T h #
# . T . B . B . H <
> B . B B . T B . #
# h . . . . T h h #
# # # # # # # # # #
