10 6
# # # # # # # # # #
# T . B T . B . H <
> B . B B T . . . #
# h . . . . . T . #
# h h . . h h h h #
# # # # # # # # # #
