11 8
# # # # # # # # # # #
# h h h h . . T h h #
# h h h . . . T h h #
# h h h . . B . h h #
# . . . B B h h h h #
> . . T B . . . . . <
# h . T h h . . . h #
# # # # # # # # # # #
