8 11
# # # # # # # #
# . . . . . h #
> B . . . . h #
# h . T . . . <
# h h h . . T #
# h h . T . h #
# h . . . . . #
# h . B . . T #
# h h . B B . #
# h h . . h h #
# # # # # # # #
