8 10
# # # # # # # #
# h h h . . h #
# T . . . . h #
# h T . B B . <
> . B . . . . #
# h h h B . h #
# h h . . . . #
# h h . . T . #
# h h . T . h #
# # # # # # # #
