7 10
# # # # # # #
# h . T . h #
# h B . . h #
# h . T . h #
# h . B B h #
# . . . . H <
# . B . . . #
> . . . T h #
# h . h h h #
# # # # # # #
