10 7
# # # # # # # # # #
# . . T h h h h h #
# . B . h . . T h #
# . . . T . B . H <
> B . . . . B . . #
# h h h h . . h h #
# # # # # # # # # #
