8 10
# # # # # # # #
# h h h . . h #
# h h h T B h #
# h h . . . . <
# . T . . . . #
> B . . B T h #
# h h h B . . #
# h h h . T . #
# h h h . . h #
# # # # # # # #
