10 9
# # # # # # # # # #
# h h h h T . . . <
# h . B . . B B . #
> B . . . . T T . #
# h . . . h h . h #
# h . . h h . . . #
# h h h h h . . . #
# h h h h h . . T #
# # # # # # # # # #
