11 11
# # # # # # # # # # #
# h h . h h h h h h #
# h . . . h h h h h #
# h . . . h h h h h #
# h . . . h h . . h #
# h h B h . . . . H <
# h . . . . . . . . #
> . B . . . B . . . #
# h T B T h h h T . #
# h h . h h h h h h #
# # # # # # # # # # #
