8 10
# # # # # # # #
# h h h T . h #
# h h . . T h #
# . . T . . . <
> B . . . B . #
# h h . B . h #
# h h h . B T #
# h h h . . . #
# h h h . . h #
# # # # # # # #
