7 9
# # # # # # #
# h . . . h #
> . . B B h #
# h . B . h #
# h h T . h #
# h . . . . <
# h . T B T #
# h . . T h #
# # # # # # #
