8 11
# # # # # # # #
# h h h h T . <
# h h . . . . #
# h . . . . h #
# T B . . . h #
# . . B h h h #
# h . . T h h #
# h . . . h h #
# . B B . h h #
> . T h h h h #
# # # # # # # #
