8 11
# # # # # # # #
# h h h . . h #
# h h h B . h #
# h h h . . H <
# h h h . T T #
# h . B . . h #
> . . . . B h #
# h . T . B . #
# h h h . . . #
# h h h . . h #
# # # # # # # #
