7 11
# # # # # # #
# h . . h h #
# . . . h h #
# . . B h h #
# h . . . H <
# h . . . . #
# T B B . . #
> . . B . h #
# h T . h h #
# h . T h h #
# # # # # # #
