9 11
# # # # # # # # #
# h h h h . h h #
# h h h . T . h #
# h . . . . T h #
# . . B B . . h #
> . B . h . h h #
# h . . . B . h #
# h . . . T . . <
# h h h . T . h #
# h h h h . h h #
# # # # # # # # #
