8 11
# # # # # # # #
# h h h . . h #
# h . . B . h #
# h . . B . . <
# h T . . B . #
# h h T . . h #
# h . . . h h #
> B T . T . h #
# h . . . h h #
# h h . h h h #
# # # # # # # #
