7 8
# # # # # # #
# h h . . h #
# . B . . H <
# . . . B . #
# T . . . T #
> B . B . T #
# h h . . h #
# # # # # # #
