7 8
# # # # # # #
# h h . . . <
# h h . . . #
# h h B T . #
# h h . B . #
# . B B T T #
> . T . . . #
# # # # # # #
