10 11
# # # # # # # # # #
# h h . h h h h h #
# h . T . h h h h #
# T . . . . h h h #
# h . . . h h h h #
# h h B h h T . h #
# h . B . B . . . <
> . . . . . B . . #
# h . . . h . . T #
# h h . h h h h h #
# # # # # # # # # #
