9 10
# # # # # # # # #
# h . h h h h h #
# . . . h . . . <
# . B . . B . . #
> . . . . . B . #
# h T h h h . B #
# h h h . T . T #
# h h h . . . h #
# h h h . . T h #
# # # # # # # # #
