11 5
# # # # # # # # # # #
# . . B . B T T . . <
# h . . . h . . . h #
> B . T . . . . B T #
# # # # # # # # # # #
