8 9
# # # # # # # #
# h . . h h h #
# . . . . . h #
> T T . T . . <
# h . B B . h #
# h . . . h h #
# h h B . h h #
# h h . . h h #
# # # # # # # #
