8 8
# # # # # # # #
# h h h T . h #
# h h h . . h #
# h h h T B . <
# . . B . B T #
# . . . B T h #
> . . . . h h #
# # # # # # # #
