9 9
# # # # # # # # #
# . . . h h h h #
# . . . h . h h #
# . . . . . . h #
# h h B B . . . <
# . . T . B . h #
# . . T h . h h #
> . . T h h h h #
# # # # # # # # #
