7 8
# # # # # # #
# h . . . h #
# h B . . h #
# T B . T h #
> . B . . . <
# h h . T . #
# h h . . h #
# # # # # # #
