9 9
# # # # # # # # #
# . T h h h h h #
# . T . . h h h #
# h . B . . B . <
# . . . B . . . #
> . . . T . h h #
# h . . h h h h #
# h . . h h h h #
# # # # # # # # #
