8 7
# # # # # # # #
# . . . . h h #
# . . . . h h #
> . B T T . . <
# h h h B . B #
# h h h . . T #
# # # # # # # #
