7 10
# # # # # # #
# . . . h h #
# B T . . h #
> T . B . h #
# h B B T . <
# h . T . . #
# h . . . h #
# h . . . h #
# h . . h h #
# # # # # # #
