8 9
# # # # # # # #
# h h h . . h #
# h h . . T h #
# h . B . B . <
# h h T . . . #
# T . T . . h #
# B B . h h h #
> . . . h h h #
# # # # # # # #
