8 7
# # # # # # # #
# h h . . h h #
# T . . T . h #
> B . . B . . <
# h h . . . h #
# h . . . B T #
# # # # # # # #
