5 9
# # # # #
# T . . <
# B B . #
# . . . #
# B . T #
# T . . #
# . . . #
> B T . #
# # # # #
