6 10
# # # # # #
# h . T h #
# . . . h #
# . . B . <
# h . B . #
# . . T . #
> . B . h #
# h . T h #
# h . . h #
# # # # # #
