9 7
# # # # # # # # #
# h h h h T T h #
# . . . B B . . <
> . . B . T . . #
# h . . . h h h #
# h . . . h h h #
# # # # # # # # #
