8 8
# # # # # # # #
# h h T . h h #
# . . B . T h #
# T B . . . h #
> T . . . B . <
# h B . . . h #
# h . . . h h #
# # # # # # # #
