8 8
# # # # # # # #
# T . . . h h #
# B . . . h h #
> . B T T h h #
# h h . . . . <
# h h h B . . #
# h h h . . . #
# # # # # # # #
