8 9
# # # # # # # #
# h h h . . . <
# h h h . . . #
# h h . . . T #
# . . . . h h #
# . B . T . h #
> . B . B . h #
# h h T . h h #
# # # # # # # #
