10 8
# # # # # # # # # #
# h h . . h h h h #
# . . . B T h h h #
> T T . . . B . h #
# h h h . . . . . <
# h h h h B . . h #
# h h h h . . h h #
# # # # # # # # # #
