9 8
# # # # # # # # #
# h h . . B T h #
# . . T . B . h #
> . . . . T T . <
# h h . . B B . #
# h h h . . . h #
# h h h . . h h #
# # # # # # # # #
