8 9
# # # # # # # #
# h . . . h h #
> . T B B . h #
# h . B . . h #
# h h . T B h #
# h h h T . . <
# h h h . T . #
# h h h . . h #
# # # # # # # #
