7 8
# # # # # # #
# h T h h h #
# . B . h h #
# . . . . h #
# T . B . . <
> . B T B . #
# h T . h h #
# # # # # # #
