7 9
# # # # # # #
# h h h . h #
# h h . . . <
# h . T B . #
# h h . B . #
# . T T . h #
# . B . h h #
> . B T h h #
# # # # # # #
