8 9
# # # # # # # #
# h h h . . h #
# h h h . T h #
# T . h . B . <
# . . h B . . #
# B B . T . h #
# T . . h h h #
> . . h h h h #
# # # # # # # #
