7 7
# # # # # # #
# h h . . h #
# . . . . h #
# T B . . . <
> B T . B . #
# h h . T h #
# # # # # # #
