8 7
# # # # # # # #
# h h . . . h #
# h . B T . h #
> . . T B . . <
# h . B . . T #
# h h . B T h #
# # # # # # # #
