7 10
# # # # # # #
# h h . h h #
# h . . . h #
# h T . . . <
# h . . B . #
# h h . h h #
# h . B T h #
> B . . . T #
# h T B . h #
# # # # # # #
