8 11
# # # # # # # #
# h h h . . h #
# h h h . . h #
# h h h . . . <
# h h . . . T #
# . . . . . h #
> . . . . . . #
# h . B T B . #
# h h . B . h #
# h h h T h h #
# # # # # # # #
