11 10
# # # # # # # # # # #
# h h h h . . . . h #
# h . T B . . . . h #
> . . . . . . . . h #
# h h h h . T T h h #
# h h h . . B . . h #
# h h h . . . . . . <
# h h h h B . . . h #
# h h h h . . h h h #
# # # # # # # # # # #
