11 7
# # # # # # # # # # #
# h h h h h h . h h #
# h T B . h . . h h #
> . . . . . . . . . <
# h . . . . B B . . #
# h h . h h T T h h #
# # # # # # # # # # #
