8 10
# # # # # # # #
# . . . . h h #
# . . . . h h #
# h T T . . h #
# . . B . . h #
> B . . . h h #
# h . . . . h #
# h . B . . . <
# h h . . T h #
# # # # # # # #
