10 6
# # # # # # # # # #
# h h . B . . T . <
# . . . . . B . . #
> B . . . . T . . #
# h T . h h h h h #
# # # # # # # # # #
