8 8
# # # # # # # #
# h T h h h h #
# . B . h h h #
# . . B . h h #
> . . . . T . <
# h . h B . . #
# h h h T . . #
# # # # # # # #
