7 7
# # # # # # #
# h T . h h #
# . . B . . <
> T . B . . #
# h . B . . #
# h . . T h #
# # # # # # #
