6 10
# # # # # #
# h . . . <
# h T . B #
# h . B T #
# h . . . #
# T . B h #
> . T . h #
# h B . h #
# h . . h #
# # # # # #
