7 7
# # # # # # #
# h h . . h #
# T . . B . <
# . . T . T #
# B B T B . #
> . . . . . #
# # # # # # #
