7 8
# # # # # # #
# h h . . h #
# . . B . . <
# . T . T . #
> . . B . h #
# h T B . h #
# h h . h h #
# # # # # # #
