11 6
# # # # # # # # # # #
# . . . . h h h h h #
# T B . . . T B T . <
> B . . T . . . B . #
# h . . h h . . . . #
# # # # # # # # # # #
