7 9
# # # # # # #
# h h T . . <
# h h . B . #
# . B . . T #
# . . . h h #
# . T B h h #
# . B T h h #
> . . h h h #
# # # # # # #
