9 8
# # # # # # # # #
# h h h h . . h #
# h h . . . . . <
# h h B B T B T #
# . . T B . . h #
# . . T . . . h #
> . . . h h h h #
# # # # # # # # #
