8 8
# # # # # # # #
# T . . h h h #
# T B . h h h #
# . B . h h h #
> B . T . . . <
# h . . . . . #
# h h . . h h #
# # # # # # # #
