7 6
# # # # # # #
# h T . . h #
> . B . B . <
# h B B T h #
# h T T h h #
# # # # # # #
