8 7
# # # # # # # #
# h h . . h h #
# h h B . B . <
# . . T . B . #
> B T T . T . #
# h . . h h h #
# # # # # # # #
