8 7
# # # # # # # #
# . B T h h h #
# . B T . h h #
> T B . . . . <
# h . h . . . #
# h h h . B T #
# # # # # # # #
