6 7
# # # # # #
# h T h h #
# T T . h #
# B B B . <
> . . . . #
# h . h h #
# # # # # #
