7 7
# # # # # # #
# h h . . h #
# . . T B h #
# . T . . . <
> . B B . . #
# h h . T h #
# # # # # # #
