5 9
# # # # #
# h . h #
# T . . <
# B . T #
# . . B #
# T B . #
# . . . #
> B T . #
# # # # #
