6 8
# # # # # #
# h T T h #
# h B B h #
# . . . . <
# . . B T #
> . B T h #
# h . h h #
# # # # # #
