7 8
# # # # # # #
# h T . h h #
# . . . h h #
> T B . h h #
# h B . B . <
# h . . . . #
# h . T . . #
# # # # # # #
