8 7
# # # # # # # #
# h h . . T h #
# h h . . B h #
# T . . . . . <
# B B . . . . #
> . . T . . h #
# # # # # # # #
