10 8
# # # # # # # # # #
# h . T . h h h h #
# h . . . h h h h #
# h . . . . . . h #
# . . . T . B . . <
> . . B B T . . h #
# h . . h h . h h #
# # # # # # # # # #
