6 9
# # # # # #
# . . . h #
# T B B . <
# . B T h #
# . . h h #
> . T . T #
# h B . . #
# h . . . #
# # # # # #
