8 9
# # # # # # # #
# h . . . . h #
# h B . . . h #
# . T B T . h #
> . . . B . h #
# h T . . T . <
# h h h . B . #
# h h h . . h #
# # # # # # # #
