8 10
# # # # # # # #
# h h h . h h #
# h h . . T h #
# h h . T . H <
# h . B B . . #
# . . . B h h #
> T . . . h h #
# h . B . h h #
# h . . . h h #
# # # # # # # #
