8 11
# # # # # # # #
# h h h . h h #
# h h T . . h #
# h . . . . h #
# h h T . . h #
# h h h . . h #
# . . B B . h #
# . B . B . H <
> . . T . . . #
# h h h . . h #
# # # # # # # #
