7 9
# # # # # # #
# h T h h h #
# T . . h h #
# . B . . h #
> B . B B h #
# h h . . H <
# h h . T . #
# h h . . h #
# # # # # # #
