8 9
# # # # # # # #
# . . h h h h #
# T H B . B . <
# h . T . T . #
# . B . . . . #
> B . . h h h #
# h . . h h h #
# h . . h h h #
# # # # # # # #
