8 10
# # # # # # # #
# h h . h . h #
# h h . . . h #
# h h . . . h #
# h h . . . H <
# h h B B . . #
# . . T B . h #
# . T . . h h #
> . B . T h h #
# # # # # # # #
