7 11
# # # # # # #
# h h . T h #
# h . . . h #
# h . B . h #
# h . . . h #
# . . . . h #
> B . . B h #
# h B T . H <
# h . . T . #
# h h . . h #
# # # # # # #
