10 8
# # # # # # # # # #
# h h h . . h h h #
# h h . . . h . h #
# h h B B . . . . <
# . . . . . T . . #
> . . . . T B . T #
# h . . h h h h h #
# # # # # # # # # #
