7 7
# # # # # # #
# h h . . h #
# . B . . H <
> B T . T . #
# h . B B h #
# h . . T h #
# # # # # # #
