11 8
# # # # # # # # # # #
# h h . . h h . . h #
# . . . B . B . . H <
> . . B . . . B . . #
# h h . . . T h h h #
# h h h . . . h h h #
# h h h T . T h h h #
# # # # # # # # # # #
