7 8
# # # # # # #
# h . . . h #
> T B . B h #
# h . B . H <
# h . B . T #
# h . . . h #
# h . T . h #
# # # # # # #
