11 8
# # # # # # # # # # #
# h . . . h h h h h #
# h B . T h h . h h #
# . . . . . B . . h #
> . . . B T . . B H <
# h . . h h T . . h #
# h h h h h h . h h #
# # # # # # # # # # #
