9 10
# # # # # # # # #
# h h h h . h h #
# h h h T . T h #
# h h . . . . h #
# h h B T . . h #
# . . B . . h h #
# . . . . . . H <
> . . . h . B B #
# h h h h . . . #
# # # # # # # # #
