8 7
# # # # # # # #
# h . . . T h #
# h . B B . h #
# T . B . . H <
> . . B . . . #
# h . T . . h #
# # # # # # # #
