7 10
# # # # # # #
# h h . . h #
# T . B T h #
# . B . . H <
# . B . T . #
# h h . . h #
# h . . . h #
> . . B . h #
# h . . . h #
# # # # # # #
