7 8
# # # # # # #
# h h . . . <
# h h . T B #
# h h . T . #
# . B B . T #
> . . B T . #
# h . . h h #
# # # # # # #
