10 6
# # # # # # # # # #
# h h . T h h h h #
# . B . T B . . H <
> . T B . . B . . #
# h h h h h . . . #
# # # # # # # # # #
