10 7
# # # # # # # # # #
# h h . . h . T H <
# T . . . B . . . #
# . B B . . . B . #
# T . . . h . . . #
> . . h h h h h h #
# # # # # # # # # #
