11 7
# # # # # # # # # # #
# h h T . h h h h h #
# . . T . . . B . . <
> . . . . B B B . h #
# h h . T . . . T . #
# h h h . . h h h h #
# # # # # # # # # # #
