7 10
# # # # # # #
# h . T h h #
# h . T . h #
# h . B . h #
# h B B . H <
# T . . . . #
# . . B . h #
> . . . h h #
# h . h h h #
# # # # # # #
