10 7
# # # # # # # # # #
# h . . . h T T . <
# h B . . h . . . #
# . . B . T T . . #
> . B . . B . . . #
# h . . h h . . . #
# # # # # # # # # #
