10 8
# # # # # # # # # #
# h h T . . h h h #
# h h . T B h h h #
# h h B . . h h h #
# . . . . . . . . <
> T . B B . . . . #
# h T . h . . h h #
# # # # # # # # # #
