11 8
# # # # # # # # # # #
# h h . . h h h h h #
# . B T B . h h h h #
> T T . . . . . . h #
# h B T . h . . . . <
# h . . B h . . . h #
# h . . . h h h h h #
# # # # # # # # # # #
