11 10
# # # # # # # # # # #
# h . . . h h h h h #
> . B . B . h h h h #
# h . . . h h h h h #
# h h h T h h h T . <
# h h . . . h . B . #
# h . . . T . . . . #
# h h . . . h h . B #
# h h h . h h h . T #
# # # # # # # # # # #
