7 10
# # # # # # #
# h h T . H <
# h . B . . #
# . B . . . #
> . . . . h #
# h B B . h #
# h . . . . #
# h h . T . #
# h h . T h #
# # # # # # #
