9 7
# # # # # # # # #
# h h . . h h h #
# . . . B B . h #
# . T . . . . H <
# . . B B . . T #
> . T . . h h h #
# # # # # # # # #
