8 11
# # # # # # # #
# h h . . h h #
# . B . T h h #
# . . B B . h #
# . . . . B h #
# h h h T . . <
# . . . T . . #
# . . . . . h #
> . T . h h h #
# h . . h h h #
# # # # # # # #
