11 8
# # # # # # # # # # #
# h h T . h h . h h #
# . . B . . . B . h #
# . T T . . . . . . <
> T B . B h . . . h #
# h . . . h h . h h #
# h h . h h h h h h #
# # # # # # # # # # #
