9 9
# # # # # # # # #
# T . T h h h h #
# . B T h h h h #
# . . . . . . h #
# h h B . T . . <
# h . B . . . . #
> B . . . . h h #
# h . . . h h h #
# # # # # # # # #
