9 11
# # # # # # # # #
# h h . . h h h #
# h . . B B . . <
# h T . . . . . #
# h h . . B . . #
# h h . T h h h #
# h . T . h h h #
> B . . . h h h #
# h . T . h h h #
# h h . h h h h #
# # # # # # # # #
