11 9
# # # # # # # # # # #
# h h h h h h . h h #
# h h h h h . . . h #
# h h . . h . . . h #
# . T . T . . . . h #
# . . . . T B B B H <
> . . . . B . . . . #
# h . . h h . . h h #
# # # # # # # # # # #
