11 8
# # # # # # # # # # #
# h h T h h h h h h #
# h . T . h h . h h #
> . . . . h . T . h #
# h . B . B B T . . <
# h . . . B . . . . #
# h h . . h h . h h #
# # # # # # # # # # #
