8 11
# # # # # # # #
# . . . h h h #
# . . T h h h #
# . . . B . h #
> B . B B . h #
# h . h . . . <
# h . . . T . #
# h . T . . h #
# h . T . h h #
# h . h . h h #
# # # # # # # #
