10 6
# # # # # # # # # #
# h h . . h h h h #
# . . . . T H T H <
# B B B . B . . . #
> T B . . . B T . #
# # # # # # # # # #
