10 9
# # # # # # # # # #
# T . T . . . . . <
# . . . h . . . h #
# . B . B . . . . #
# h B T h h h h h #
# . . T . B . h h #
# . . . . . . h h #
> . . . . . . h h #
# # # # # # # # # #
