7 10
# # # # # # #
# h h . T h #
# h h . . h #
# h h . B . <
# h h . . . #
# h h T B h #
# h . T . h #
> . . B . h #
# h . . . h #
# # # # # # #
