7 7
# # # # # # #
# h T T . . <
# . B B . . #
> T . . B . #
# h . B h h #
# h . T h h #
# # # # # # #
