7 10
# # # # # # #
# T . . h h #
# B . . h h #
> . . B T h #
# h h B . h #
# h . T . h #
# h . . T . <
# h h . B . #
# h h . . h #
# # # # # # #
