7 9
# # # # # # #
# . . . h h #
# . . . h h #
# T B B T h #
> . . . B h #
# h h B . . <
# h h T . . #
# h h T . h #
# # # # # # #
