8 8
# # # # # # # #
# h . . . h h #
# . T . B h h #
> . B . . h h #
# h . . . B . <
# h . . . T . #
# h h h . . T #
# # # # # # # #
