7 11
# # # # # # #
# h . . h h #
# . . T h h #
> . B . . h #
# h . B T h #
# h . . . . <
# h . . T . #
# h . . B h #
# h . . . h #
# h . . h h #
# # # # # # #
