5 9
# # # # #
# . . . <
# T T . #
# B . . #
# . . . #
# . B . #
# T B . #
> . . h #
# # # # #
