11 6
# # # # # # # # # # #
# T . B . . h h h h #
# h T B . h . . . h #
> . . . . T B . . . <
# h h h h h . . . h #
# # # # # # # # # # #
