10 7
# # # # # # # # # #
# h h . . h h h h #
# T . . . . . T . <
> B T B B . . . . #
# h h . T . . B . #
# h h h . h h h h #
# # # # # # # # # #
