9 9
# # # # # # # # #
# h h h . h h h #
# h h . T T h h #
# h h . . . B . <
# h h B . B . . #
# . . . . T h h #
# . . . h h h h #
> . . . h h h h #
# # # # # # # # #
