9 9
# # # # # # # # #
# h h T . h h h #
# h . . . h h h #
# h . . . . . . <
# h h . . B . . #
# . . T B T . . #
# . B . h h h h #
> . . . h h h h #
# # # # # # # # #
