7 9
# # # # # # #
# h h . h h #
# h . B T h #
> T B . . h #
# h . . T h #
# h h B B . <
# h h . . . #
# h h . T h #
# # # # # # #
