10 7
# # # # # # # # # #
# h h h T T h h h #
# h . . . B . h h #
# h . . . B . . . <
# . . . . . . . . #
> . . . . . T B . #
# # # # # # # # # #
