10 7
# # # # # # # # # #
# . h . h h h h h #
# T . . h h . T h #
# . . . . B . . . <
# B . . . . . . . #
> . h . h . B T h #
# # # # # # # # # #
