11 6
# # # # # # # # # # #
# h h . . h . . . h #
# . . . . . . B . . <
> B . T . T B B T h #
# h h h h h . T h h #
# # # # # # # # # # #
