8 6
# # # # # # # #
# h h h . . . <
# T . T . B . #
> . B . T B . #
# h . . h h h #
# # # # # # # #
