7 8
# # # # # # #
# h . h h h #
# . B T . h #
# . B . . h #
# . T B . . <
> . . B T . #
# h h T . h #
# # # # # # #
