9 9
# # # # # # # # #
# . . . h h h h #
# . . . h h h h #
# . . . . h h h #
# h h B . . h h #
# T B . . . . . <
# . . T h . . . #
> B T . h . . . #
# # # # # # # # #
