8 9
# # # # # # # #
# . T . h h h #
# . . . T . h #
> . . . B B h #
# h h . . . . <
# h h . T . . #
# h h . . B h #
# h h . . . h #
# # # # # # # #
