7 7
# # # # # # #
# h h . h h #
# h . . . h #
> . B . B . <
# h T B T h #
# h h T h h #
# # # # # # #
