7 10
# # # # # # #
# h h T h h #
# h . . . h #
# h . T B . <
# h B B T . #
# . T . h h #
> . . B h h #
# h . . h h #
# h . . h h #
# # # # # # #
