7 8
# # # # # # #
# h h . . h #
# . . B . . <
> . T B . . #
# h h B T B #
# h h . . T #
# h h T . . #
# # # # # # #
