9 9
# # # # # # # # #
# h h h . . h h #
# h h . . . h h #
# h h . T B T . <
# h h T B . B . #
# . . . . . . . #
# B . . h h h h #
> T . . h h h h #
# # # # # # # # #
