8 7
# # # # # # # #
# h . B T h h #
> . . B T . h #
# h . B . B . <
# h . . . . . #
# h h T T h h #
# # # # # # # #
