9 9
# # # # # # # # #
# . . . h h h h #
# . . B h h h h #
# . . . . . h h #
# h h . B . . . <
# T . . . . . . #
# . . T h . . . #
> T B . h h h h #
# # # # # # # # #
