6 9
# # # # # #
# . . . h #
# B . . h #
# T . . . <
# h h B B #
# . . T T #
# . B T h #
> . . . h #
# # # # # #
