7 9
# # # # # # #
# h T . . h #
> . . . . . <
# h . B . h #
# h . B h h #
# h . B T h #
# h T . . h #
# h . B T h #
# # # # # # #
