6 10
# # # # # #
# h . . h #
# . . B h #
# . . T . <
> . . . . #
# h B . h #
# h . . . #
# h T B T #
# h . . h #
# # # # # #
