7 9
# # # # # # #
# h h . h h #
# . . T . h #
> . B . B h #
# h . B . h #
# h h T . . <
# h h . . . #
# h h . T h #
# # # # # # #
