7 11
# # # # # # #
# h h T h h #
# . T B . h #
> . . B . h #
# h . T . h #
# h h . h h #
# h h B . . <
# h h . . B #
# h . . . T #
# h . . h h #
# # # # # # #
