9 8
# # # # # # # # #
# h h h . . . h #
# h h h . B . . <
# h h . . . T h #
# T T . B . h h #
# . . B h h h h #
> . . . h h h h #
# # # # # # # # #
