7 10
# # # # # # #
# h . . . h #
# h . . . h #
# h . . . . <
# h T B . . #
# T T . . h #
# . . B h h #
# B . . h h #
> . . . h h #
# # # # # # #
