8 11
# # # # # # # #
# h h h . h h #
# h h . . . h #
# h . T B . . <
# h h . . B h #
# h . . . T h #
# . . . . . h #
> . . . . h h #
# h B . . h h #
# h . T h h h #
# # # # # # # #
