11 9
# # # # # # # # # # #
# h h . . . h h h h #
# h . . . . . h h h #
# h h . . . h h h h #
# h h B . h h . h h #
# h . . . h . . . h #
> . T T . . . B B . <
# h h h h h . . T h #
# # # # # # # # # # #
