9 7
# # # # # # # # #
# h h h h h . h #
# . T T . B . . <
# . B . B B . . #
> . . T . T . . #
# h h h h h . h #
# # # # # # # # #
