9 6
# # # # # # # # #
# h T h . T . . <
# . B . B B T . #
# . . . . . B . #
> . . T h h h h #
# # # # # # # # #
