8 10
# # # # # # # #
# h h T . . h #
# h . . . . . <
# . B . T . h #
> T . . B h h #
# h . B . . h #
# h . . . . . #
# h h . . . h #
# h h h . h h #
# # # # # # # #
