9 7
# # # # # # # # #
# T . . h h h h #
# . . . B . h h #
> . B . . . . . <
# h T h h . B . #
# h h h h . . T #
# # # # # # # # #
