7 7
# # # # # # #
# . . B T h #
# T B . . h #
> . . . . . <
# h h . B . #
# h h T . h #
# # # # # # #
