7 10
# # # # # # #
# h T . . h #
# h . . . h #
# h . B . h #
# h . . . h #
# h B . T h #
> . . T . . <
# h . B . h #
# h . . h h #
# # # # # # #
