11 9
# # # # # # # # # # #
# h h h h h h . h h #
# h h h h h . . T h #
# h h h h . B . T . <
# h h T h . . . B . #
# h . . . B . . . . #
> . . . . h . . h h #
# h . . . h h h h h #
# # # # # # # # # # #
