9 7
# # # # # # # # #
# h T B . h h h #
> . . T B T h h #
# h . B T B . . <
# h . . . . . . #
# h h h . . h h #
# # # # # # # # #
