10 6
# # # # # # # # # #
# h h h h h . . h #
# . T . T B . . . <
# h B . . . B T . #
> . . . . . h h h #
# # # # # # # # # #
