8 8
# # # # # # # #
# h . . h . . <
# . . . B . . #
> . . . . . h #
# h . T B . h #
# h . B T h h #
# h h T . h h #
# # # # # # # #
