6 7
# # # # # #
# h T . h #
# . B . . <
> . B T . #
# h . B . #
# h . T h #
# # # # # #
