8 6
# # # # # # # #
# . . . h h h #
# . . T B . . <
> B T B B . . #
# h h T T h h #
# # # # # # # #
