7 8
# # # # # # #
# T B . h h #
# . . . h h #
> . . B . h #
# h h . B . <
# h h T . . #
# h h T . . #
# # # # # # #
