8 6
# # # # # # # #
# . . . . . . <
# . B . B B T #
> . . . . T . #
# h h h h T . #
# # # # # # # #
