10 8
# # # # # # # # # #
# h . h h h . h h #
# . . . . . . . h #
# . B T . . . T h #
> . . B . . . . . <
# h h h . . . B T #
# h h h h . . h h #
# # # # # # # # # #
