7 7
# # # # # # #
# h . . h h #
# . . T h h #
> T B B . . <
# h . T B . #
# h . . . . #
# # # # # # #
