6 10
# # # # # #
# h . . . <
# h . . . #
# h T . . #
# h B . . #
# . . . B #
> B T . . #
# h . B T #
# h . . T #
# # # # # #
