8 8
# # # # # # # #
# h T T h h h #
# . B B h h h #
> T . . . . h #
# h T . . B . <
# h . B . . . #
# h h . . h h #
# # # # # # # #
