5 9
# # # # #
# . . . <
# . . T #
# B T . #
# T B B #
# . . . #
# . . . #
> . . . #
# # # # #
