9 8
# # # # # # # # #
# h h h h . . h #
> . . T B . . . <
# h . . . T B . #
# h h . T . . h #
# h h h . B . h #
# h h h . B T h #
# # # # # # # # #
