9 8
# # # # # # # # #
# h h h . . h h #
# h h h . . h h #
# . . . T . . h #
# h . . . T B . <
> . B T B . . . #
# h h h . . h h #
# # # # # # # # #
