7 8
# # # # # # #
# h h . . h #
# h h T . h #
# h h B . . <
# . B . . . #
# . B . . h #
> . . T T h #
# # # # # # #
