9 9
# # # # # # # # #
# h h h h . . h #
# h h h h B T h #
# h h . . . . . <
# . . B B T . . #
> . . . . . . h #
# h h . . . . T #
# h h h . . . h #
# # # # # # # # #
