6 9
# # # # # #
# h . T h #
# T . B h #
> B . . h #
# h . . h #
# h T . . <
# h B . . #
# h . . h #
# # # # # #
