7 9
# # # # # # #
# h . T . h #
# . . . . h #
# . . . . . <
# . . . . . #
# B B . . h #
> T . B . h #
# h T . h h #
# # # # # # #
