10 7
# # # # # # # # # #
# . B T h h . . h #
# . . . . . . . . <
# . . B . B T . . #
> . . . h T . . h #
# h h h h h . h h #
# # # # # # # # # #
