8 8
# # # # # # # #
# h T . h h h #
# . . B . . h #
> . . . . . . <
# h . T B B . #
# h . . T . h #
# h h h . h h #
# # # # # # # #
