10 7
# # # # # # # # # #
# h h h h h . . . <
# h h h . . . T . #
# T B . B . . . . #
> . . T B . h h h #
# h . . h h h h h #
# # # # # # # # # #
