8 11
# # # # # # # #
# h . . h h h #
# . . B . T h #
> . . T . . h #
# h . B . . h #
# h . . h h h #
# h h . . . h #
# h T . . . . <
# h h B . . h #
# h h . . h h #
# # # # # # # #
