11 11
# # # # # # # # # # #
# h h h h h h . T h #
# . B . T h . . . h #
# . . B . . . B . . <
> . . T . h . . . h #
# h h h h . . h h h #
# h h h . . . h h h #
# h h . . . . . h h #
# h h h . . . . h h #
# h h h h . . h h h #
# # # # # # # # # # #
