8 10
# # # # # # # #
# h . T . h h #
> B . . . . h #
# h . B . . h #
# h h . . B H <
# h h . B T . #
# h . T . . h #
# h h . . . h #
# h h h . h h #
# # # # # # # #
