7 10
# # # # # # #
# h h . . h #
# h . . . h #
> T . B B H <
# h . B . . #
# h h . B h #
# h T . . h #
# h . . T h #
# h . . . h #
# # # # # # #
