7 9
# # # # # # #
# h h . . H <
# h . . . . #
# . B . . T #
> B . B . h #
# h . . . . #
# h . . . . #
# h T B T h #
# # # # # # #
