8 8
# # # # # # # #
# h h . . h h #
# . T . B . . <
# B B . . . . #
# . . . . . . #
# . . . h . h #
> T . T h h h #
# # # # # # # #
