11 7
# # # # # # # # # # #
# h h h h . . h . H <
# h T . . B . T . T #
# . . . . B . . B . #
> . . . . B . h . . #
# h h . . h h h . . #
# # # # # # # # # # #
