8 10
# # # # # # # #
# h h . . . h #
# h . . . . h #
> B T . . . H <
# h . . . . . #
# h h B . . h #
# h h . B T h #
# h h T B . h #
# h h . . h h #
# # # # # # # #
