8 9
# # # # # # # #
# h h h h . h #
# h h . . . H <
# h . B B B T #
# T . B . . . #
> . . T h . h #
# h . . h h h #
# h . . h h h #
# # # # # # # #
