9 11
# # # # # # # # #
# . . h h h . h #
# . . T . . . . <
# . B T . . T . #
> . . . h T . . #
# h h h . . . . #
# h h . . B B . #
# h h . . . . h #
# h h h B . . h #
# h h h . . h h #
# # # # # # # # #
