8 10
# # # # # # # #
# h h . . . H <
# h h B . B B #
# h . T . . . #
# . . T . h h #
> T . . . . h #
# h . . B . . #
# h . . . . . #
# h h h . h h #
# # # # # # # #
