8 11
# # # # # # # #
# h h h . T h #
# h . h . . h #
# . . . B . . <
# . B . . . . #
> B . . T . h #
# h h h . B h #
# h h h . . T #
# h h h . . T #
# h h h . . h #
# # # # # # # #
