7 11
# # # # # # #
# h . . . h #
# h . B . h #
# . B . . . <
> . . . . . #
# h . . . h #
# h B T h h #
# h . B T h #
# h T . T h #
# h . . h h #
# # # # # # #
