7 9
# # # # # # #
# h T . . h #
# h . B . h #
# T . . . h #
> . . B B h #
# h h . . H <
# h h B . . #
# h h . T h #
# # # # # # #
