9 9
# # # # # # # # #
# h h h h . . h #
# h h h h T . h #
# h h h h . . H <
# h h . T B . . #
# . . . . B . h #
> B . . . . . h #
# h h h T B . h #
# # # # # # # # #
