7 8
# # # # # # #
# . T . h h #
# B . . h h #
# T B T h h #
# . B . T . <
> . B . . . #
# h . . h h #
# # # # # # #
