7 8
# # # # # # #
# h . T h h #
# . . B h h #
> B . . h h #
# h B . . . <
# h T . . T #
# h . . B T #
# # # # # # #
