10 9
# # # # # # # # # #
# T . . . . . . H <
# . T . h . . B h #
# . B . B . . . . #
# . . . h h h h h #
# . T . h h h h h #
> B . . h h h h h #
# h . . h h h h h #
# # # # # # # # # #
