10 8
# # # # # # # # # #
# h h . . h h h h #
# h . . B h h h h #
# T . . . . T T . <
# . . B . . . . . #
> T B . . . B . . #
# h . . h h h h h #
# # # # # # # # # #
