9 11
# # # # # # # # #
# h h . h h h h #
# h . T . B . h #
> . B . . B . h #
# h . . T . . H <
# h h . h . . . #
# h h T . . . h #
# h h . . B h h #
# h h . . . h h #
# h h . h . h h #
# # # # # # # # #
