7 7
# # # # # # #
# h . . . H <
# h B B . T #
# T B . T . #
> B . . . . #
# h . . h h #
# # # # # # #
