9 7
# # # # # # # # #
# . B . T . . H <
# . . . . . . . #
# . T . . B . . #
> . T B B . h h #
# h . . h h h h #
# # # # # # # # #
