11 8
# # # # # # # # # # #
# h h h h . . h h h #
# h h . T . . . h h #
# . . . . . . B . h #
# h . . B h . B . H <
> . . T B . T . . h #
# h h h h h h . h h #
# # # # # # # # # # #
