10 6
# # # # # # # # # #
# h h . . h h h h #
# h . B . . B . H <
> . B . B . T . T #
# h T T . . . B . #
# # # # # # # # # #
