10 8
# # # # # # # # # #
# h h h h . . T h #
# h h h h . . . h #
# h . h h . . T h #
# . . B . B . . . <
# . B B . . . . T #
> . . . h . T h h #
# # # # # # # # # #
