8 11
# # # # # # # #
# h h h h . h #
# h h h . T H <
# h h . . T . #
# h h . . . . #
# . B B . h h #
# . T . . h h #
> B . . . . h #
# h h B . . h #
# h h . . h h #
# # # # # # # #
