10 6
# # # # # # # # # #
# h h h h h . T H <
# T . T . . . . . #
# h B B B h B . . #
> . T B . . . . . #
# # # # # # # # # #
