10 6
# # # # # # # # # #
# T . . . . . T H <
# h B B . B T . H #
> B . . . B . B . #
# h h h . T h h h #
# # # # # # # # # #
