10 6
# # # # # # # # # #
# h h . . h h h h #
# h B T B B . . H <
> . B . T B T . H #
# h . B . T . . . #
# # # # # # # # # #
