10 6
# # # # # # # # # #
# T B . . . . h h #
# T B T T . B . H <
> B . . B . . . . #
# h h h h . . h h #
# # # # # # # # # #
