9 11
# # # # # # # # #
# h h h h . h h #
# h h h . . T h #
# h h . . . . . <
# h h h . . . h #
# h h h B . h h #
# . . B . . h h #
# T . . B B T h #
> . . T . . . h #
# h h . . . h h #
# # # # # # # # #
