10 9
# # # # # # # # # #
# h h h h . . h h #
# h h h h . . h h #
# h h . B B . . h #
# h h . . . . . h #
# . . . . . . T H <
> . T B T . . B . #
# h . . h . . h h #
# # # # # # # # # #
