10 8
# # # # # # # # # #
# . . T h h . h h #
# . B . h . T . h #
> . . . . T B . . <
# h h . . B B . h #
# h h h h T . h h #
# h h h h . . h h #
# # # # # # # # # #
