8 10
# # # # # # # #
# . . . h h h #
# . . T h h h #
# T . . . h h #
# h . . B B . <
# . . B . . . #
> . . B . . T #
# h . T h h h #
# h . . h h h #
# # # # # # # #
