10 8
# # # # # # # # # #
# h h h h h . T . <
# h h h h h . T . #
# h . . . h . . . #
> B . . B B . . . #
# h . T . B T . h #
# h h h . . h h h #
# # # # # # # # # #
