10 7
# # # # # # # # # #
# h h h h . . . h #
# . . . B T T . H <
# . . . . T B . . #
> B . . . . . B . #
# h h h h . . h h #
# # # # # # # # # #
