11 7
# # # # # # # # # # #
# h h h h h . T h h #
# h h h . . . B . h #
# . T . . . B B . H <
# h . . . h . . . h #
> B T . . . . . . . #
# # # # # # # # # # #
