8 9
# # # # # # # #
# h . . h h h #
# . . B h h h #
> . B . h h h #
# h . . . . . <
# h . B . T T #
# h h . . B T #
# h h T . h h #
# # # # # # # #
