9 7
# # # # # # # # #
# h T h h . . . <
# . . . h . . . #
# . . T B B . T #
> B . . T . B . #
# h . h . . h h #
# # # # # # # # #
