8 10
# # # # # # # #
# h . T h h h #
# T T . h h h #
# . . . B . . <
# h B . . . . #
# h . . . . . #
# h h . T h h #
> B . . B . h #
# h . . . h h #
# # # # # # # #
