8 10
# # # # # # # #
# h T . . . h #
# h . . B . h #
# h h . . B . <
# h h . . . . #
# h h h . . h #
# h h . B h h #
# . B . . . h #
> . T T T . h #
# # # # # # # #
