8 10
# # # # # # # #
# h h h . h h #
# h h . . . h #
# h T . T B . <
# h h . B . h #
# h h h . . h #
# . . . B B . #
# T . . . . T #
> . . . . . h #
# # # # # # # #
