10 6
# # # # # # # # # #
# T . . . B . . H <
# B . B B T T T h #
> . . . . . B . . #
# h . . h h h h h #
# # # # # # # # # #
