10 6
# # # # # # # # # #
# h . h . . . T H <
# . B . B . B . . #
# . T B . . B . T #
> . . T h . . h h #
# # # # # # # # # #
