7 11
# # # # # # #
# h h . . h #
# h . . . h #
# . . . . . <
# . . . . . #
# T B B . h #
# B B . . h #
> . h . T T #
# h h . T . #
# h h . . h #
# # # # # # #
