10 6
# # # # # # # # # #
# h h . . h h h h #
# . B . . B T T H <
> B . T B . B . . #
# h h . T . H . B #
# # # # # # # # # #
