10 6
# # # # # # # # # #
# h h h h h . . h #
# . B . . . . B H <
# . B . B B . T T #
> T T H B . . . h #
# # # # # # # # # #
