8 8
# # # # # # # #
# h T . . h h #
# h . T . h h #
# . B . B h h #
> B . B . . . <
# h . . . . . #
# h . . . T T #
# # # # # # # #
