9 9
# # # # # # # # #
# . . . T T . h #
# h . . . . B h #
> . B . . . B . <
# h h h h . . . #
# h h h . . T h #
# h h T . . B h #
# h h h . . . h #
# # # # # # # # #
