10 6
# # # # # # # # # #
# h h T B H T . H <
# . T B . B . T . #
> B . . B . . B . #
# h . . h h h h h #
# # # # # # # # # #
