7 8
# # # # # # #
# h h . . h #
# . . . . . <
> B T . B . #
# h h . B T #
# h h . T B #
# h h . T . #
# # # # # # #
