7 11
# # # # # # #
# h . T h h #
# . B . h h #
# . . B . H <
# h . B . . #
# h . T . B #
# . . . . . #
> . . . h h #
# h T . h h #
# h . . h h #
# # # # # # #
