7 11
# # # # # # #
# h . T h h #
# . . B . h #
# . . . . h #
# h B . . h #
# h . B h h #
# h . T . h #
> . B . . H <
# h . . . h #
# h h T h h #
# # # # # # #
