9 10
# # # # # # # # #
# h . h . . h h #
# T B . . . h h #
# . . . B . . h #
> . . T . . . h #
# h . h B . h h #
# h h h . . T h #
# h h h B . . H <
# h h h . . . h #
# # # # # # # # #
