10 7
# # # # # # # # # #
# h h h h h . . h #
# h . B . B . B . <
> . . . . T . B . #
# h T T T h . . . #
# h . . h h h h h #
# # # # # # # # # #
