8 11
# # # # # # # #
# h . . . h h #
# . . . . h h #
# . T T . . h #
# . . B . T h #
# h h . . . h #
# h . B B . h #
> . . . B . H <
# h . . . . . #
# h h . . . h #
# # # # # # # #
