8 10
# # # # # # # #
# h . . . B H <
# . B . B B . #
# . T . . . . #
# h . . . h h #
# T . . . h h #
> T . . . . h #
# h . . . . h #
# h . . . h h #
# # # # # # # #
