8 11
# # # # # # # #
# h h . T h h #
# h . . . h h #
> B . . . T h #
# h . . B T h #
# h h . . . h #
# h h B B . h #
# h h . . . H <
# h h . . . . #
# h h h . . h #
# # # # # # # #
