10 7
# # # # # # # # # #
# h h h h h . . h #
# . T . . T . . h #
> B . T . B . . H <
# h . . h h B B . #
# h h h h h . . . #
# # # # # # # # # #
