8 8
# # # # # # # #
# h h h . . h #
# T T . . . H <
# T B . B . . #
# . . . B h h #
> . . B . h h #
# h . . h h h #
# # # # # # # #
