8 9
# # # # # # # #
# h h . . . h #
# h h T . . H <
# h h . . . h #
# h h h . B h #
# . . T B B . #
# h . . B . . #
> T . . . . h #
# # # # # # # #
