11 8
# # # # # # # # # # #
# h h . h h h . h h #
# h . . . h . T . h #
> . . . . B . . . H <
# h . B T B . . . h #
# h . . . . B . h h #
# h h T . h h h h h #
# # # # # # # # # # #
