11 8
# # # # # # # # # # #
# h h h h h h . . h #
# h h . h . B . . H <
# h . . . T . T . . #
> B . T B B . . . h #
# h . . . h . . . h #
# h h . h h h h h h #
# # # # # # # # # # #
