10 8
# # # # # # # # # #
# h h . . h h . h #
# . . . . . . . H <
> B T . B . . T . #
# h h . B T . . . #
# h h B . . h h h #
# h h . . . h h h #
# # # # # # # # # #
