10 9
# # # # # # # # # #
# h h h h h . B H <
# h h h h h . . . #
# h h h h h T . . #
# h . . . . . h h #
> . B . B B T . . #
# h . . . h T . . #
# h h h h h . . . #
# # # # # # # # # #
