10 7
# # # # # # # # # #
# h h h T . . h h #
# h h . . . B h h #
# . . . . . . T H <
# . B B . . . B . #
> . . . h . T h h #
# # # # # # # # # #
