6 9
# # # # # #
# h . . h #
# . . B h #
> B . . h #
# h . . H <
# h T B . #
# h B . T #
# h . . T #
# # # # # #
