8 7
# # # # # # # #
# h . . h h h #
# . B . h h h #
> . B . . . . <
# h B T T . T #
# h . T B . . #
# # # # # # # #
