6 11
# # # # # #
# h . . h #
# h . T h #
# h B B H <
# h . . . #
# . . B h #
# T . . h #
# . . B h #
# . . . h #
> T h . h #
# # # # # #
