10 7
# # # # # # # # # #
# h h . . h h h h #
# h T . . h h h h #
> . T B B T B . H <
# h . B . . . . . #
# h h h h . . h h #
# # # # # # # # # #
