11 10
# # # # # # # # # # #
# h h h h h h . h h #
# h h . T h . T . h #
# . . B . . . . B H <
# . B . T . . . . . #
> . . . . . h . h h #
# h . . . . h h h h #
# h h . B . h h h h #
# h h . . h h h h h #
# # # # # # # # # # #
