10 9
# # # # # # # # # #
# h . . . h . B H <
# h . . . . . . T #
# h . . . h B . . #
# h h . T h . . . #
# h . . . h . B . #
> B T . . . . . . #
# h . . . h h h h #
# # # # # # # # # #
