9 7
# # # # # # # # #
# h h . . h h h #
# . . . B B . H <
# . . . . . B . #
> . . . B . T . #
# h T . h h T h #
# # # # # # # # #
