7 10
# # # # # # #
# h . . h h #
# . . T h h #
# . . T h h #
# h T . . H <
# . . B . B #
> . B B . . #
# h . . h h #
# h . . h h #
# # # # # # #
