10 9
# # # # # # # # # #
# . . . h h T T h #
# . . . . . . B H <
> B . . . . . . . #
# h . . B T h h h #
# h h B . . . h h #
# h h . . . . h h #
# h h h . . h h h #
# # # # # # # # # #
