8 7
# # # # # # # #
# h h h . T H <
# h h h . . B #
# . T B . B . #
> . . B . . h #
# h T . h h h #
# # # # # # # #
