6 10
# # # # # #
# T . . h #
# . . T h #
> B . T h #
# h B B h #
# h . . . <
# h . . . #
# h T B . #
# h h . h #
# # # # # #
