7 8
# # # # # # #
# h T . T H <
# h . . . . #
# . B B B T #
> . . . h h #
# h B . h h #
# h . . h h #
# # # # # # #
