11 8
# # # # # # # # # # #
# h h h . h h h h h #
# h h . . . . . T h #
# h . . T . B . . h #
# . B B . . . . . H <
> . T . . . B . . . #
# h . . h h . . h h #
# # # # # # # # # # #
