11 8
# # # # # # # # # # #
# h h h h h h . h h #
# . . T . . B . . h #
# . . . B . T . . H <
# T . . . B . . . h #
> . . B . . h h h h #
# h . . h h h h h h #
# # # # # # # # # # #
