11 8
# # # # # # # # # # #
# h h . h h h h h h #
# h . . T h h . T h #
> . B . . . . . B H <
# h . B . B . . . T #
# h h . h h . . . h #
# h h h h h h . h h #
# # # # # # # # # # #
