9 9
# # # # # # # # #
# . . T h h h h #
# T . . h h h h #
# . . . B . . H <
# h B h B . . . #
# T . . . . . . #
# . B . h h h h #
> . . . h h h h #
# # # # # # # # #
