7 10
# # # # # # #
# . B T . h #
# T . B . h #
> B T . . h #
# h h B . H <
# h . . . . #
# h . . . h #
# h . . . h #
# h h . . h #
# # # # # # #
