9 7
# # # # # # # # #
# h h . . . T h #
# . . . T . B h #
> B . . . . . H <
# h h . B B . . #
# h h h h T . h #
# # # # # # # # #
