6 10
# # # # # #
# . T . h #
# T B T h #
# . . . h #
# . B B h #
> . . . h #
# h . . H <
# h B . . #
# h . . h #
# # # # # #
