7 8
# # # # # # #
# h h T . h #
# . . T . H <
> B . . B . #
# h . B B . #
# h . . . h #
# h h T h h #
# # # # # # #
