8 7
# # # # # # # #
# h . . h h h #
# . T B h h h #
> B . B . . . <
# h . T . . . #
# h . T . B T #
# # # # # # # #
