11 8
# # # # # # # # # # #
# h h h h h . h h h #
# h h h h . . . h h #
# h h h h B . . . h #
# . T . B . . . . H <
> T . . . . B T B . #
# h . . h h . . h h #
# # # # # # # # # # #
