10 6
# # # # # # # # # #
# h . . . . T B H <
# . B B . . T . . #
> T . B . . B T . #
# h . . h h h h h #
# # # # # # # # # #
