10 6
# # # # # # # # # #
# h . B . . B T H <
> B . T B T . . . #
# h . . . . . B . #
# h . T h h h h h #
# # # # # # # # # #
