10 6
# # # # # # # # # #
# h h h . . B . H <
# . B T . T B H B #
> . B . B . T . . #
# h . T h . . h h #
# # # # # # # # # #
