10 6
# # # # # # # # # #
# h h . . h h h h #
# T B . T B . . H <
> B . . B . . . T #
# h h . T . . B . #
# # # # # # # # # #
