9 10
# # # # # # # # #
# h h h . T h h #
# h . . . T h h #
# h . . . . . h #
# h . T . B . h #
# h h . . B h h #
# . . B . B . . <
# . . . h . . . #
> . . . h T . . #
# # # # # # # # #
