11 8
# # # # # # # # # # #
# h h T h h T . h h #
# h . T . . . . . h #
> . . . B . . . . . <
# h . . T h . B . . #
# h h . h h B . B h #
# h h h h h . . . h #
# # # # # # # # # # #
