10 6
# # # # # # # # # #
# h h . B . T H H <
# . . B . B T . . #
> . . B B . . B . #
# h T T h h h h h #
# # # # # # # # # #
