10 6
# # # # # # # # # #
# T . . . . B . H <
# h . B . h . T B #
> B . . . B . . T #
# h h h h h h . T #
# # # # # # # # # #
