7 10
# # # # # # #
# h . . T h #
> . . . B h #
# h . . . h #
# h h h B h #
# h h . . . <
# h h . T . #
# h h . B T #
# h h h . h #
# # # # # # #
