5 8
# # # # #
# . . . <
# . B . #
# T B . #
# T B . #
> . T . #
# h . h #
# # # # #
