9 9
# # # # # # # # #
# h h h h . . . <
# h h h h . . . #
# h . . T B . . #
> . . T B . h h #
# h . . B . T h #
# h h h . . . h #
# h h h . . . h #
# # # # # # # # #
