7 7
# # # # # # #
# h h . . h #
# . B T . h #
# T B . . . <
> . . . B . #
# h T . h h #
# # # # # # #
