10 5
# # # # # # # # # #
# . . T B . . . . <
# h . . . . . B . #
> . T . B . T . . #
# # # # # # # # # #
