11 10
# # # # # # # # # # #
# h . . T h . . . h #
# h . . . . . B . . <
# h . B . h T B . h #
# h h . h h . T h h #
# h . . . h . . . h #
> . . . . . . . . . #
# h . . . h . . . h #
# h h . h h h . h h #
# # # # # # # # # # #
