10 8
# # # # # # # # # #
# h h h . . h h h #
# T . . . . . . h #
# . B . B T . . . <
> . . . . . . B . #
# h h h h . T . h #
# h h h h h . h h #
# # # # # # # # # #
