8 8
# # # # # # # #
# . . . h h h #
# . . . h h h #
> B . . T h h #
# h h B . . . <
# h h . B . T #
# h h T . . . #
# # # # # # # #
