7 10
# # # # # # #
# h h . . h #
# h h B . h #
# h T B . . <
# . . . . T #
> . . . . h #
# h B B . h #
# h . T . h #
# h T . h h #
# # # # # # #
