9 7
# # # # # # # # #
# . . . h h h h #
# . . B B . h h #
# . T T . B T . <
> . . . h . . . #
# h h h h . . . #
# # # # # # # # #
