9 8
# # # # # # # # #
# h h h h T . h #
# . h . . . B . <
# . . . . . . . #
# . . . . B . . #
# T B . h T . . #
> . h . h . . . #
# # # # # # # # #
