8 6
# # # # # # # #
# . . T B . . <
# B T B . T . #
> T . . . B . #
# h h h h . . #
# # # # # # # #
