8 9
# # # # # # # #
# h h h . . h #
# T . B T . h #
# . T . B . . <
> . . . . . . #
# h . . . . h #
# h h B . . h #
# h h . . . h #
# # # # # # # #
