8 7
# # # # # # # #
# T . . h h h #
# . B . . h h #
> . . B . . . <
# h . T B . T #
# h h . . h h #
# # # # # # # #
