9 7
# # # # # # # # #
# h h . . h h h #
# . . B T . h h #
> T . . . B . . <
# h h . . . B . #
# h h . . T . h #
# # # # # # # # #
