7 10
# # # # # # #
# h h . . h #
# h . B . h #
# . . B T . <
> . . . . . #
# h . . . h #
# h . B . . #
# h h T . . #
# h h T . . #
# # # # # # #
