6 8
# # # # # #
# h T . . <
# h . . T #
# . B T B #
> . . B . #
# h . . h #
# h . . h #
# # # # # #
