10 7
# # # # # # # # # #
# h h h . . h h h #
# h . . . T . B . <
# h . . . B B . . #
> . . T T . . . . #
# h . . . h h h h #
# # # # # # # # # #
