9 11
# # # # # # # # #
# h h . . h h h #
# h . . . . h h #
# h . . . . h h #
# h h . B . . h #
# h h . . . . h #
# . . B . . . h #
# B T . . T . . <
> T . . . . . h #
# h h h h . h h #
# # # # # # # # #
