11 9
# # # # # # # # # # #
# . . . . . T . . . <
# h . B . h B . . h #
> T . . . . . . . . #
# h . T . h h h h h #
# h . . . h h h h h #
# h . B . h h h h h #
# h . . . h h h h h #
# # # # # # # # # # #
