7 9
# # # # # # #
# h . B T h #
> . . . . . <
# h . B T h #
# h . B h h #
# h . T . h #
# h . . . . #
# h T B . h #
# # # # # # #
