10 7
# # # # # # # # # #
# h h . B T h h h #
# h . . . . . h h #
# . . . . . . . . <
> . . . . B . B . #
# h . . h h T . T #
# # # # # # # # # #
