8 7
# # # # # # # #
# h h . . . h #
# h h . B B . <
# . T . . T h #
# . B T h h h #
> . . . h h h #
# # # # # # # #
