8 5
# # # # # # # #
# . . . . . . <
# B B B . . . #
> T T T . . . #
# # # # # # # #
