8 7
# # # # # # # #
# h h . . h h #
# T . B . . h #
> B T B . . . <
# h h . B . h #
# h h T T h h #
# # # # # # # #
