9 7
# # # # # # # # #
# h . T . B . h #
# . T B . . . . <
> . B . . B . h #
# h . . h T h h #
# h T . h h h h #
# # # # # # # # #
