8 6
# # # # # # # #
# . T B . T h #
# B . B . . h #
> T . . . . . <
# h h h h . . #
# # # # # # # #
