7 8
# # # # # # #
# h h . . . <
# h . . B . #
# . B . . T #
> B . . T h #
# h . . h h #
# h T . h h #
# # # # # # #
