8 7
# # # # # # # #
# h h h h . h #
# T . . . B . <
# . B . . . . #
> . . T B B T #
# h h h h T h #
# # # # # # # #
