8 9
# # # # # # # #
# h h . . h h #
# h . B . h h #
# . T . . h h #
> T . . B h h #
# h . B T . h #
# h . B T . . <
# h h . . . h #
# # # # # # # #
