6 10
# # # # # #
# h . T . <
# h B B . #
# h T . . #
# h . . . #
# . B . h #
# . T . h #
> . B . h #
# h . T h #
# # # # # #
