8 7
# # # # # # # #
# h h T T h h #
# . . B B T h #
> . . . B . . <
# h h h . . B #
# h h h . . T #
# # # # # # # #
