8 7
# # # # # # # #
# . . . . . . <
# . . . . T . #
# T B . B B . #
> . . T . . h #
# h . . h h h #
# # # # # # # #
