6 9
# # # # # #
# h T T . <
# h . . . #
# h . . T #
# h h B B #
# . . . . #
# B . B h #
> T . . h #
# # # # # #
