6 9
# # # # # #
# h T . . <
# h B . . #
# h T . . #
# h . B . #
# . . . h #
# . . . h #
> B T . h #
# # # # # #
