11 7
# # # # # # # # # # #
# h h T T h h . h h #
# h . B T h . . . h #
> . . B B . B . . . <
# h . . . h . T . h #
# h h h h h h . h h #
# # # # # # # # # # #
