6 8
# # # # # #
# h . T h #
# T . B . <
> . B . B #
# h . B T #
# h . . . #
# h T h . #
# # # # # #
