9 7
# # # # # # # # #
# h h h h . . . <
# . . . T . B . #
# . . . T . . . #
> . . . . . B . #
# h h h h T B . #
# # # # # # # # #
