11 5
# # # # # # # # # # #
# h . . . h . B T h #
# . . . B B . T . . <
> . . . T h . . . h #
# # # # # # # # # # #
