10 9
# # # # # # # # # #
# h h h . . h h h #
# h . . . . T . h #
# h . . T . B B . <
# h . . . h . . T #
> . . . . B . . . #
# h . . . h h h h #
# h h . h h h h h #
# # # # # # # # # #
