7 10
# # # # # # #
# h . . . . <
# . . . . T #
> . B . . . #
# h . . . . #
# h . . . B #
# h h . . T #
# h . . . . #
# h . . B T #
# # # # # # #
