9 5
# # # # # # # # #
# . B . T . T h #
# . . . . B B . <
> . T B T . . h #
# # # # # # # # #
