8 7
# # # # # # # #
# h h h . . h #
# h h h . T h #
# h . . T B . <
> B . . B B T #
# h . . T . h #
# # # # # # # #
