9 6
# # # # # # # # #
# h h h h h . . <
# . B T . . . . #
# . . . . B . h #
> T B T T B . h #
# # # # # # # # #
