10 6
# # # # # # # # # #
# . . . h h . . h #
# . B . B T B T . <
> . . B T . T . . #
# h h . . . . . h #
# # # # # # # # # #
