7 8
# # # # # # #
# h h T h h #
# h . T . h #
# . B . . h #
# . T . B . <
> . . B . . #
# h . . . h #
# # # # # # #
