11 7
# # # # # # # # # # #
# h h h h h h . T h #
# h h h . . T . . . <
# . . . . B . T . . #
# . . B B B . h h h #
> . . T . h h h h h #
# # # # # # # # # # #
