10 9
# # # # # # # # # #
# h h h h . T h h #
# h h h . . . h h #
# h h h . B . h h #
# . B . T . T h h #
> B . B . . . T . <
# h . . . . . . . #
# h h h h . . h h #
# # # # # # # # # #
