11 9
# # # # # # # # # # #
# h h h h . . h h h #
# h h h h . . h h h #
# h h h T B T . h h #
# h h h B . . . h h #
# . . . T . . . B . <
> . . . . . . B . . #
# h . . h h T . h h #
# # # # # # # # # # #
