11 7
# # # # # # # # # # #
# h h h h h . . h h #
# h h h h h . T . h #
# . B . . . . . . H <
# . . . B . B . B . #
> T . T . h . . h h #
# # # # # # # # # # #
