7 11
# # # # # # #
# h . . h h #
# T B . h h #
> B . T . h #
# h B . . h #
# h . . . . <
# h B . . . #
# h . T . h #
# h . T . h #
# h . h . h #
# # # # # # #
