7 11
# # # # # # #
# h h T h h #
# h . . . h #
# h . B . . <
# . B . . h #
> B . T h h #
# h . B . h #
# h T . T h #
# h h . . h #
# h h . h h #
# # # # # # #
