8 9
# # # # # # # #
# h h . . h h #
# T . B T . h #
> B . . B . h #
# h h h . . . <
# h h h B . T #
# h h h . . T #
# h h h h . h #
# # # # # # # #
