9 11
# # # # # # # # #
# h h h h . h h #
# h h h . . T h #
# h h h B . . . <
# h h h . . . . #
# h h h B . h h #
# h h h . . h h #
# h h . . T . h #
# . . B . B T h #
> . . . . T h h #
# # # # # # # # #
