11 7
# # # # # # # # # # #
# h h h h h h . . h #
# h . B . B T . . H <
> B . . T T . B . . #
# h h h h h . . . h #
# h h h h h . . . h #
# # # # # # # # # # #
