9 9
# # # # # # # # #
# h . . . . . h #
# . B T . B . . <
> . . . . . . h #
# h . B h h h h #
# h B . . . h h #
# h . T . . . h #
# h h T . T h h #
# # # # # # # # #
