8 9
# # # # # # # #
# h h . . T h #
# h . . . . h #
# h . T B T h #
# . B . h h h #
> B . . . . . <
# h B . . T . #
# h . . . . . #
# # # # # # # #
