7 10
# # # # # # #
# h h T . h #
# h . B . h #
# . . B T . <
# h . T B . #
# h h . B h #
# . . . . h #
# . T . . h #
> . . . . h #
# # # # # # #
