7 10
# # # # # # #
# h T h h h #
# T . . h h #
# . T B . h #
> B . . . h #
# h . B . h #
# h . . B . <
# h . . . . #
# h T . . h #
# # # # # # #
