7 11
# # # # # # #
# h h h . h #
# h h T . . <
# h . B . . #
# . B . B T #
> B . . h h #
# h . . . h #
# h . T T h #
# h . . . . #
# h h h . . #
# # # # # # #
