11 8
# # # # # # # # # # #
# h h . . h h h h h #
# . . . T . h . T h #
> T . B . B . . . . <
# h h . . B . . B . #
# h h . T . h h h h #
# h h h . h h h h h #
# # # # # # # # # # #
