9 9
# # # # # # # # #
# h h h h . . . <
# h h h h . B . #
# . . . h . . B #
# T . . B . . . #
> . . . h . . . #
# h . h h B T . #
# h h h h . T T #
# # # # # # # # #
