10 9
# # # # # # # # # #
# . . . h h h h h #
# . . . h h . . h #
> . B . . . B . . <
# h h . B . . . T #
# h h h B . . h h #
# h h h . . . . h #
# h h h T T T h h #
# # # # # # # # # #
